AcrR_Down	AcrR_Down	P
Ada_Up	Ada_Up	P
Ada_Down	Ada_Down	P
AdiY_Up	AdiY_Up	P
AgaR_Down	AgaR_Down	P
AlaS_Down	AlaS_Down	P
AllR_Down	AllR_Down	P
AllS_Up	AllS_Up	P
AlpA_Up	AlpA_Up	P
AlsR_Down	AlsR_Down	P
AppY_Up	AppY_Up	P
AraC_Up	AraC_Up	P
AraC_Down	AraC_Down	P
ArcA_Down	ArcA_Down	P
ArcA_Up	ArcA_Up	P
ArgP_Up	ArgP_Up	P
ArgR_Down	ArgR_Down	P
ArgR_Up	ArgR_Up	P
AscG_Down	AscG_Down	P
AsnC_Up	AsnC_Up	P
AsnC_Down	AsnC_Down	P
AtoC_Up	AtoC_Up	P
BaeR_Up	BaeR_Up	P
BetI_Down	BetI_Down	P
BirA_Down	BirA_Down	P
BolA_Up	BolA_Up	P
BolA_Down	BolA_Down	P
CRP_Down	CRP_Down	P
CRP_Up	CRP_Up	P
CadC_Up	CadC_Up	P
CaiF_Up	CaiF_Up	P
Cbl_Up	Cbl_Up	P
CdaR_Up	CdaR_Up	P
ChbR_Up	ChbR_Up	P
ChbR_Down	ChbR_Down	P
CpxR_Up	CpxR_Up	P
CpxR_Down	CpxR_Down	P
CsgD_Up	CsgD_Up	P
CsgD_Down	CsgD_Down	P
CsiR_Down	CsiR_Down	P
CspA_Up	CspA_Up	P
CueR_Up	CueR_Up	P
CueR_Down	CueR_Down	P
CusR_Up	CusR_Up	P
CynR_Down	CynR_Down	P
CynR_Up	CynR_Up	P
CysB_Up	CysB_Up	P
CysB_Down	CysB_Down	P
CytR_Down	CytR_Down	P
CytR_Up	CytR_Up	P
DcuR_Up	DcuR_Up	P
DeoR_Down	DeoR_Down	P
DgsA_Down	DgsA_Down	P
DhaR_Up	DhaR_Up	P
DhaR_Down	DhaR_Down	P
DicA_Down	DicA_Down	P
DnaA_Down	DnaA_Down	P
DnaA_Up	DnaA_Up	P
DsdC_Up	DsdC_Up	P
DsdC_Down	DsdC_Down	P
EbgR_Down	EbgR_Down	P
EnvY_Up	EnvY_Up	P
EvgA_Up	EvgA_Up	P
ExuR_Down	ExuR_Down	P
FNR_Up	FNR_Up	P
FNR_Down	FNR_Down	P
FabR_Down	FabR_Down	P
FadR_Up	FadR_Up	P
FadR_Down	FadR_Down	P
FeaR_Up	FeaR_Up	P
FhlA_Up	FhlA_Up	P
Fis_Down	Fis_Down	P
Fis_Up	Fis_Up	P
FlhDC_Up	FlhDC_Up	P
FlhDC_Down	FlhDC_Down	P
FruR_Up	FruR_Up	P
FruR_Down	FruR_Down	P
FucR_Up	FucR_Up	P
Fur_Down	Fur_Down	P
Fur_Up	Fur_Up	P
GadE_Up	GadE_Up	P
GadW_Down	GadW_Down	P
GadX_Up	GadX_Up	P
GalR_Up	GalR_Up	P
GalR_Down	GalR_Down	P
GalS_Up	GalS_Up	P
GalS_Down	GalS_Down	P
GatR_Down	GatR_Down	P
GcvA_Down	GcvA_Down	P
GcvA_Up	GcvA_Up	P
GlcC_Up	GlcC_Up	P
GlcC_Down	GlcC_Down	P
GlpR_Down	GlpR_Down	P
GntR_Down	GntR_Down	P
GutM_Up	GutM_Up	P
GutR_Down	GutR_Down	P
H-NS_Down	H-NS_Down	P
H-NS_Up	H-NS_Up	P
HU_Down	HU_Down	P
HU_Up	HU_Up	P
HcaR_Up	HcaR_Up	P
HcaR_Down	HcaR_Down	P
HdfR_Down	HdfR_Down	P
HipB_Down	HipB_Down	P
HyfR_Up	HyfR_Up	P
IHF_Up	IHF_Up	P
IHF_Down	IHF_Down	P
IclR_Down	IclR_Down	P
IdnR_Down	IdnR_Down	P
IdnR_Up	IdnR_Up	P
IlvY_Up	IlvY_Up	P
IlvY_Down	IlvY_Down	P
IscR_Down	IscR_Down	P
IscR_Up	IscR_Up	P
KdgR_Down	KdgR_Down	P
KdpE_Up	KdpE_Up	P
LacI_Down	LacI_Down	P
LeuO_Up	LeuO_Up	P
LexA_Down	LexA_Down	P
LldR_Down	LldR_Down	P
LrhA_Up	LrhA_Up	P
LrhA_Down	LrhA_Down	P
Lrp_Down	Lrp_Down	P
Lrp_Up	Lrp_Up	P
LsrR_Down	LsrR_Down	P
LysR_Up	LysR_Up	P
LysR_Down	LysR_Down	P
MalI_Down	MalI_Down	P
MalT_Up	MalT_Up	P
MarA_Up	MarA_Up	P
MarA_Down	MarA_Down	P
MarR_Down	MarR_Down	P
MelR_Up	MelR_Up	P
MelR_Down	MelR_Down	P
MetJ_Down	MetJ_Down	P
MetR_Up	MetR_Up	P
MetR_Down	MetR_Down	P
MhpR_Up	MhpR_Up	P
MngR_Down	MngR_Down	P
MntR_Down	MntR_Down	P
ModE_Up	ModE_Up	P
ModE_Down	ModE_Down	P
MprA_Down	MprA_Down	P
MtlR_Down	MtlR_Down	P
Nac_Down	Nac_Down	P
Nac_Up	Nac_Up	P
NadR_Down	NadR_Down	P
NagC_Down	NagC_Down	P
NagC_Up	NagC_Up	P
NanR_Down	NanR_Down	P
NarL_Down	NarL_Down	P
NarL_Up	NarL_Up	P
NarP_Up	NarP_Up	P
NarP_Down	NarP_Down	P
NhaR_Up	NhaR_Up	P
NikR_Down	NikR_Down	P
NorR_Down	NorR_Down	P
NorR_Up	NorR_Up	P
NsrR_Down	NsrR_Down	P
NtrC_Up	NtrC_Up	P
NtrC_Down	NtrC_Down	P
OmpR_Down	OmpR_Down	P
OmpR_Up	OmpR_Up	P
OxyR_Up	OxyR_Up	P
OxyR_Down	OxyR_Down	P
PaaX_Down	PaaX_Down	P
PdhR_Down	PdhR_Down	P
PdhR_Up	PdhR_Up	P
PepA_Down	PepA_Down	P
PhoB_Up	PhoB_Up	P
PhoB_Down	PhoB_Down	P
PhoP_Down	PhoP_Down	P
PhoP_Up	PhoP_Up	P
PrpR_Up	PrpR_Up	P
PrpR_Down	PrpR_Down	P
PspF_Up	PspF_Up	P
PspF_Down	PspF_Down	P
PurR_Down	PurR_Down	P
PutA_Down	PutA_Down	P
QseB_Up	QseB_Up	P
RbsR_Down	RbsR_Down	P
RcsAB_Up	RcsAB_Up	P
RcsAB_Down	RcsAB_Down	P
RhaR_Up	RhaR_Up	P
RhaS_Up	RhaS_Up	P
Rob_Up	Rob_Up	P
RtcR_Up	RtcR_Up	P
SdiA_Down	SdiA_Down	P
SdiA_Up	SdiA_Up	P
SlyA_Up	SlyA_Up	P
SoxR_Up	SoxR_Up	P
SoxR_Down	SoxR_Down	P
SoxS_Up	SoxS_Up	P
SoxS_Down	SoxS_Down	P
TdcA_Up	TdcA_Up	P
TdcR_Up	TdcR_Up	P
TorR_Down	TorR_Down	P
TorR_Up	TorR_Up	P
TreR_Down	TreR_Down	P
TrpR_Down	TrpR_Down	P
TyrR_Down	TyrR_Down	P
TyrR_Up	TyrR_Up	P
UhpA_Up	UhpA_Up	P
UidR_Down	UidR_Down	P
UlaR_Down	UlaR_Down	P
UxuR_Down	UxuR_Down	P
XapR_Up	XapR_Up	P
XylR_Up	XylR_Up	P
YdeO_Up	YdeO_Up	P
YeiL_Up	YeiL_Up	P
YiaJ_Down	YiaJ_Down	P
ZntR_Up	ZntR_Up	P
ZraR_Up	ZraR_Up	P
Zur_Down	Zur_Down	P
