METHIONINEPATHWAY	METHIONINEPATHWAY	P
PENG_RAPAMYCIN_DN	PENG_RAPAMYCIN_DN	P
MENSSEN_MYC_UP	MENSSEN_MYC_UP	P
RNA_POLYMERASE	RNA_POLYMERASE	P
CACAMPATHWAY	CACAMPATHWAY	P
BRENTANI_CYTOSKELETON	BRENTANI_CYTOSKELETON	P
SIG_PIP3_SIGNALING_IN_B_LYMPHOCYTES	SIG_PIP3_SIGNALING_IN_B_LYMPHOCYTES	P
ZELLER_MYC_DN	ZELLER_MYC_DN	P
PASSERINI_EM	PASSERINI_EM	P
IL18PATHWAY	IL18PATHWAY	P
TSP1PATHWAY	TSP1PATHWAY	P
FLAGELLAR_ASSEMBLY	FLAGELLAR_ASSEMBLY	P
SA_B_CELL_RECEPTOR_COMPLEXES	SA_B_CELL_RECEPTOR_COMPLEXES	P
ROME_INSULIN_2F_UP	ROME_INSULIN_2F_UP	P
INOSITOL_METABOLISM	INOSITOL_METABOLISM	P
G2PATHWAY	G2PATHWAY	P
SULFUR_METABOLISM	SULFUR_METABOLISM	P
BROCKE_IL6	BROCKE_IL6	P
UEDA_MOUSE_LIVER	UEDA_MOUSE_LIVER	P
GLYCEROLIPID_METABOLISM	GLYCEROLIPID_METABOLISM	P
LE_MYELIN_UP	LE_MYELIN_UP	P
METHIONINE_METABOLISM	METHIONINE_METABOLISM	P
ALKPATHWAY	ALKPATHWAY	P
GLYCOSAMINOGLYCAN_DEGRADATION	GLYCOSAMINOGLYCAN_DEGRADATION	P
GLYCINE_SERINE_AND_THREONINE_METABOLISM	GLYCINE_SERINE_AND_THREONINE_METABOLISM	P
SIG_INSULIN_RECEPTOR_PATHWAY_IN_CARDIAC_MYOCYTES	SIG_INSULIN_RECEPTOR_PATHWAY_IN_CARDIAC_MYOCYTES	P
IGF1MTORPATHWAY	IGF1MTORPATHWAY	P
CHIARETTI_T_ALL	CHIARETTI_T_ALL	P
SA_MMP_CYTOKINE_CONNECTION	SA_MMP_CYTOKINE_CONNECTION	P
PASSERINI_COMPLEMENT	PASSERINI_COMPLEMENT	P
STREPTOMYCIN_BIOSYNTHESIS	STREPTOMYCIN_BIOSYNTHESIS	P
PHENYLALANINE_METABOLISM	PHENYLALANINE_METABOLISM	P
PEPTIDE_GPCRS	PEPTIDE_GPCRS	P
MCALPAINPATHWAY	MCALPAINPATHWAY	P
SASAKI_TCELL_LYMPHOMA_VS_CD4_UP	SASAKI_TCELL_LYMPHOMA_VS_CD4_UP	P
SHEPARD_CELL_PROLIFERATION	SHEPARD_CELL_PROLIFERATION	P
AGPCRPATHWAY	AGPCRPATHWAY	P
SRCRPTPPATHWAY	SRCRPTPPATHWAY	P
DRUG_RESISTANCE_AND_METABOLISM	DRUG_RESISTANCE_AND_METABOLISM	P
COLLER_MYC_DN	COLLER_MYC_DN	P
CDMACPATHWAY	CDMACPATHWAY	P
ERBB4PATHWAY	ERBB4PATHWAY	P
GRANDVAUX_IFN_NOT_IRF3_UP	GRANDVAUX_IFN_NOT_IRF3_UP	P
GRANDVAUX_IRF3_UP	GRANDVAUX_IRF3_UP	P
AGUIRRE_PANCREAS_CHR1	AGUIRRE_PANCREAS_CHR1	P
MAGRANGEAS_MULTIPLE_MYELOMA_IGG_VS_IGA_DN	MAGRANGEAS_MULTIPLE_MYELOMA_IGG_VS_IGA_DN	P
GANGLIOSIDE_BIOSYNTHESIS	GANGLIOSIDE_BIOSYNTHESIS	P
PURINE_METABOLISM	PURINE_METABOLISM	P
HEPARAN_SULFATE_BIOSYNTHESIS	HEPARAN_SULFATE_BIOSYNTHESIS	P
FLECHNER_KIDNEY_TRANSPLANT_REJECTION_UP	FLECHNER_KIDNEY_TRANSPLANT_REJECTION_UP	P
SODDPATHWAY	SODDPATHWAY	P
ACETYLCHOLINE_SYNTHESIS	ACETYLCHOLINE_SYNTHESIS	P
NOS1PATHWAY	NOS1PATHWAY	P
MITRPATHWAY	MITRPATHWAY	P
WNT_SIGNALING	WNT_SIGNALING	P
CHEN_LUNG_SURVIVAL	CHEN_LUNG_SURVIVAL	P
FLECHNER_KIDNEY_TRANSPLANT_REJECTION_PBL_UP	FLECHNER_KIDNEY_TRANSPLANT_REJECTION_PBL_UP	P
KANNAN_P53_UP	KANNAN_P53_UP	P
ROME_INSULIN_2F_DN	ROME_INSULIN_2F_DN	P
GPCRDB_CLASS_A_RHODOPSIN_LIKE	GPCRDB_CLASS_A_RHODOPSIN_LIKE	P
ALKALOID_BIOSYNTHESIS_II	ALKALOID_BIOSYNTHESIS_II	P
DER_IFNB_UP	DER_IFNB_UP	P
BCRPATHWAY	BCRPATHWAY	P
KLEIN_PEL_DN	KLEIN_PEL_DN	P
VOBESITYPATHWAY	VOBESITYPATHWAY	P
PLCEPATHWAY	PLCEPATHWAY	P
FLECHNER_KIDNEY_TRANSPLANT_WELL_PBL_DN	FLECHNER_KIDNEY_TRANSPLANT_WELL_PBL_DN	P
DISTECHE_XINACTIVATED_GENES	DISTECHE_XINACTIVATED_GENES	P
INTRINSICPATHWAY	INTRINSICPATHWAY	P
SMITH_HCV_INDUCED_HCC_UP	SMITH_HCV_INDUCED_HCC_UP	P
HCMVPATHWAY	HCMVPATHWAY	P
SPRYPATHWAY	SPRYPATHWAY	P
CFTRPATHWAY	CFTRPATHWAY	P
CCR3PATHWAY	CCR3PATHWAY	P
ST_PHOSPHOINOSITIDE_3_KINASE_PATHWAY	ST_PHOSPHOINOSITIDE_3_KINASE_PATHWAY	P
INSULINPATHWAY	INSULINPATHWAY	P
PTC1PATHWAY	PTC1PATHWAY	P
TELPATHWAY	TELPATHWAY	P
TNF_AND_FAS_NETWORK	TNF_AND_FAS_NETWORK	P
LIZUKA_L1_GR_G1	LIZUKA_L1_GR_G1	P
LIZUKA_G1_GR_G2	LIZUKA_G1_GR_G2	P
IL12PATHWAY	IL12PATHWAY	P
HBXPATHWAY	HBXPATHWAY	P
AGUIRRE_PANCREAS_CHR6	AGUIRRE_PANCREAS_CHR6	P
FERRANDO_CHEMO_RESPONSE_PATHWAY	FERRANDO_CHEMO_RESPONSE_PATHWAY	P
BUTANOATE_METABOLISM	BUTANOATE_METABOLISM	P
CBLPATHWAY	CBLPATHWAY	P
GCRPATHWAY	GCRPATHWAY	P
NELSON_ANDROGEN_DN	NELSON_ANDROGEN_DN	P
ARGININE_AND_PROLINE_METABOLISM	ARGININE_AND_PROLINE_METABOLISM	P
HOX_GENES	HOX_GENES	P
SA_REG_CASCADE_OF_CYCLIN_EXPR	SA_REG_CASCADE_OF_CYCLIN_EXPR	P
CORDERO_KRAS_KD_VS_CONTROL_DN	CORDERO_KRAS_KD_VS_CONTROL_DN	P
UBIQUINONE_BIOSYNTHESIS	UBIQUINONE_BIOSYNTHESIS	P
CARM1PATHWAY	CARM1PATHWAY	P
NUCLEOTIDE_METABOLISM	NUCLEOTIDE_METABOLISM	P
CHESLER_BRAIN_CIS_GENES	CHESLER_BRAIN_CIS_GENES	P
DER_IFNB_DN	DER_IFNB_DN	P
IFNGPATHWAY	IFNGPATHWAY	P
TARTE_PLASMA_BLASTIC	TARTE_PLASMA_BLASTIC	P
PLK3PATHWAY	PLK3PATHWAY	P
HSP27PATHWAY	HSP27PATHWAY	P
GPCRS_CLASS_A_RHODOPSIN_LIKE	GPCRS_CLASS_A_RHODOPSIN_LIKE	P
STEROID_BIOSYNTHESIS	STEROID_BIOSYNTHESIS	P
TALL1PATHWAY	TALL1PATHWAY	P
SA_CASPASE_CASCADE	SA_CASPASE_CASCADE	P
CK1PATHWAY	CK1PATHWAY	P
SHEPARD_NEG_REG_OF_CELL_PROLIFERATION	SHEPARD_NEG_REG_OF_CELL_PROLIFERATION	P
CARM_ERPATHWAY	CARM_ERPATHWAY	P
ELECTRON_TRANSPORT_CHAIN	ELECTRON_TRANSPORT_CHAIN	P
FRASOR_ER_UP	FRASOR_ER_UP	P
FATTY_ACID_METABOLISM	FATTY_ACID_METABOLISM	P
HEME_BIOSYNTHESIS	HEME_BIOSYNTHESIS	P
CITRATE_CYCLE_TCA_CYCLE	CITRATE_CYCLE_TCA_CYCLE	P
AMINOSUGARS_METABOLISM	AMINOSUGARS_METABOLISM	P
CD40PATHWAY	CD40PATHWAY	P
BYSTRYKH_FGF3_TARGETS_GLOCUS	BYSTRYKH_FGF3_TARGETS_GLOCUS	P
KENNY_WNT_DN	KENNY_WNT_DN	P
LEE_E2F1_UP	LEE_E2F1_UP	P
IL7PATHWAY	IL7PATHWAY	P
KUROKAWA_5FU_IFN_SENSITIVE_VS_RESISTANT_DN	KUROKAWA_5FU_IFN_SENSITIVE_VS_RESISTANT_DN	P
HISTIDINE_METABOLISM	HISTIDINE_METABOLISM	P
BREAST_CANCER_ESTROGEN_SIGNALING	BREAST_CANCER_ESTROGEN_SIGNALING	P
STRIATED_MUSCLE_CONTRACTION	STRIATED_MUSCLE_CONTRACTION	P
HUMAN_MITODB_6_2002	HUMAN_MITODB_6_2002	P
ATP_SYNTHESIS	ATP_SYNTHESIS	P
RADAEVA_IFNA_UP	RADAEVA_IFNA_UP	P
PROSTAGLANDIN_AND_LEUKOTRIENE_METABOLISM	PROSTAGLANDIN_AND_LEUKOTRIENE_METABOLISM	P
ALTERNATIVEPATHWAY	ALTERNATIVEPATHWAY	P
SHIPP_FL_VS_DLBCL_DN	SHIPP_FL_VS_DLBCL_DN	P
GOLUB_ALL_VS_AML_UP	GOLUB_ALL_VS_AML_UP	P
ERKPATHWAY	ERKPATHWAY	P
ST_T_CELL_SIGNAL_TRANSDUCTION	ST_T_CELL_SIGNAL_TRANSDUCTION	P
AGUIRRE_PANCREAS_CHR12	AGUIRRE_PANCREAS_CHR12	P
PYRIMIDINE_METABOLISM	PYRIMIDINE_METABOLISM	P
EOSINOPHILSPATHWAY	EOSINOPHILSPATHWAY	P
IL3PATHWAY	IL3PATHWAY	P
ST_DIFFERENTIATION_PATHWAY_IN_PC12_CELLS	ST_DIFFERENTIATION_PATHWAY_IN_PC12_CELLS	P
TCRMOLECULE	TCRMOLECULE	P
INTEGRIN_MEDIATED_CELL_ADHESION_KEGG	INTEGRIN_MEDIATED_CELL_ADHESION_KEGG	P
AMINOACYL_TRNA_BIOSYNTHESIS	AMINOACYL_TRNA_BIOSYNTHESIS	P
EPHA4PATHWAY	EPHA4PATHWAY	P
ACHPATHWAY	ACHPATHWAY	P
PHOSPHATIDYLINOSITOL_SIGNALING_SYSTEM	PHOSPHATIDYLINOSITOL_SIGNALING_SYSTEM	P
MPRPATHWAY	MPRPATHWAY	P
GO_ROS	GO_ROS	P
PGC1APATHWAY	PGC1APATHWAY	P
ACE2PATHWAY	ACE2PATHWAY	P
MANALO_HYPOXIA_UP	MANALO_HYPOXIA_UP	P
LDLPATHWAY	LDLPATHWAY	P
GPCRDB_CLASS_B_SECRETIN_LIKE	GPCRDB_CLASS_B_SECRETIN_LIKE	P
OSAWA_TNFA_HEPATOCYTE_UP	OSAWA_TNFA_HEPATOCYTE_UP	P
EPOPATHWAY	EPOPATHWAY	P
DNA_DAMAGE_SIGNALING	DNA_DAMAGE_SIGNALING	P
PARK_HSC_VS_MPP_DN	PARK_HSC_VS_MPP_DN	P
INOSITOL_PHOSPHATE_METABOLISM	INOSITOL_PHOSPHATE_METABOLISM	P
IL1RPATHWAY	IL1RPATHWAY	P
HYPERTROPHY_MODEL	HYPERTROPHY_MODEL	P
METPATHWAY	METPATHWAY	P
O_GLYCAN_BIOSYNTHESIS	O_GLYCAN_BIOSYNTHESIS	P
GLUCOCORTICOID_MINERALOCORTICOID_METABOLISM	GLUCOCORTICOID_MINERALOCORTICOID_METABOLISM	P
SA_PTEN_PATHWAY	SA_PTEN_PATHWAY	P
NUTT_GBN_VS_AO_DN	NUTT_GBN_VS_AO_DN	P
AGUIRRE_PANCREAS_CHR8	AGUIRRE_PANCREAS_CHR8	P
INFLAMPATHWAY	INFLAMPATHWAY	P
SHEPARD_BMYB_MORPHOLINO_DN	SHEPARD_BMYB_MORPHOLINO_DN	P
BHATTACHARYA_ESC_UP	BHATTACHARYA_ESC_UP	P
CALCIUM_REGULATION_IN_CARDIAC_CELLS	CALCIUM_REGULATION_IN_CARDIAC_CELLS	P
CHEMICALPATHWAY	CHEMICALPATHWAY	P
YE_INTRAMETASTATIC_HCC_UP	YE_INTRAMETASTATIC_HCC_UP	P
PYRUVATE_METABOLISM	PYRUVATE_METABOLISM	P
STATIN_PATHWAY_PHARMGKB	STATIN_PATHWAY_PHARMGKB	P
KUROKAWA_5FU_IFN_SENSITIVE_VS_RESISTANT_UP	KUROKAWA_5FU_IFN_SENSITIVE_VS_RESISTANT_UP	P
FLECHNER_KIDNEY_TRANSPLANT_WELL_DN	FLECHNER_KIDNEY_TRANSPLANT_WELL_DN	P
BYSTRYKH_HSC_BRAIN_TRANS_GLOCUS	BYSTRYKH_HSC_BRAIN_TRANS_GLOCUS	P
RNAPATHWAY	RNAPATHWAY	P
NITROGEN_METABOLISM	NITROGEN_METABOLISM	P
NO1PATHWAY	NO1PATHWAY	P
AGUIRRE_PANCREAS_CHR9	AGUIRRE_PANCREAS_CHR9	P
PASSERINI_APOPTOSIS	PASSERINI_APOPTOSIS	P
CROONQUIST_RAS_STROMA_DN	CROONQUIST_RAS_STROMA_DN	P
BADPATHWAY	BADPATHWAY	P
BIOSYNTHESIS_OF_STEROIDS	BIOSYNTHESIS_OF_STEROIDS	P
ERYTHPATHWAY	ERYTHPATHWAY	P
MRPPATHWAY	MRPPATHWAY	P
HOGERKORP_ANTI_CD44_UP	HOGERKORP_ANTI_CD44_UP	P
ERBB3PATHWAY	ERBB3PATHWAY	P
BYSTRYKH_SCP2_CIS_TRANSCRIPTS_GLOCUS	BYSTRYKH_SCP2_CIS_TRANSCRIPTS_GLOCUS	P
GOLUB_ALL_VS_AML_DN	GOLUB_ALL_VS_AML_DN	P
WIELAND_HEPATITIS_B_INDUCED	WIELAND_HEPATITIS_B_INDUCED	P
ANDROGEN_AND_ESTROGEN_METABOLISM	ANDROGEN_AND_ESTROGEN_METABOLISM	P
LEE_CIP_UP	LEE_CIP_UP	P
AKAPCENTROSOMEPATHWAY	AKAPCENTROSOMEPATHWAY	P
TCA	TCA	P
CROONQUIST_IL6_RAS_UP	CROONQUIST_IL6_RAS_UP	P
GLUCONEOGENESIS	GLUCONEOGENESIS	P
REELINPATHWAY	REELINPATHWAY	P
BYSTRYKH_HSC_CIS_GLOCUS	BYSTRYKH_HSC_CIS_GLOCUS	P
TNFR2PATHWAY	TNFR2PATHWAY	P
THELPERPATHWAY	THELPERPATHWAY	P
HIVNEFPATHWAY	HIVNEFPATHWAY	P
RECKPATHWAY	RECKPATHWAY	P
ROSS_CBF_LEUKEMIA	ROSS_CBF_LEUKEMIA	P
N_GLYCAN_BIOSYNTHESIS	N_GLYCAN_BIOSYNTHESIS	P
KIM_TH_CELLS_DN	KIM_TH_CELLS_DN	P
CTLPATHWAY	CTLPATHWAY	P
CARDIACEGFPATHWAY	CARDIACEGFPATHWAY	P
PKCPATHWAY	PKCPATHWAY	P
MAPKKK_CASCADE	MAPKKK_CASCADE	P
LOTEM_LEUKEMIA_UP	LOTEM_LEUKEMIA_UP	P
RIBOSOMAL_PROTEINS	RIBOSOMAL_PROTEINS	P
ABRAHAM_MM_VS_AL_DN	ABRAHAM_MM_VS_AL_DN	P
1_2_DICHLOROETHANE_DEGRADATION	1_2_DICHLOROETHANE_DEGRADATION	P
GLYCOSPHINGOLIPID_METABOLISM	GLYCOSPHINGOLIPID_METABOLISM	P
APOPTOSIS_KEGG	APOPTOSIS_KEGG	P
CARBON_FIXATION	CARBON_FIXATION	P
MAPK_CASCADE	MAPK_CASCADE	P
PASSERINI_PROLIFERATION	PASSERINI_PROLIFERATION	P
TARTE_MATURE_PC	TARTE_MATURE_PC	P
CDC42RACPATHWAY	CDC42RACPATHWAY	P
SA_DIACYLGLYCEROL_SIGNALING	SA_DIACYLGLYCEROL_SIGNALING	P
BREAST_DUCTAL_CARCINOMA_GENES	BREAST_DUCTAL_CARCINOMA_GENES	P
GLYCOLYSISPATHWAY	GLYCOLYSISPATHWAY	P
WNT_TARGETS	WNT_TARGETS	P
LONGEVITYPATHWAY	LONGEVITYPATHWAY	P
HUMAN_CD34_ENRICHED_TRANSCRIPTION_FACTORS	HUMAN_CD34_ENRICHED_TRANSCRIPTION_FACTORS	P
DEATHPATHWAY	DEATHPATHWAY	P
CHAUHAN_2ME2	CHAUHAN_2ME2	P
PENG_GLUTAMINE_DN	PENG_GLUTAMINE_DN	P
RANPATHWAY	RANPATHWAY	P
CHESLER_D6MIT150_TRANSCRIPTION_FACTORS_GLOCUS	CHESLER_D6MIT150_TRANSCRIPTION_FACTORS_GLOCUS	P
PENG_RAPAMYCIN_UP	PENG_RAPAMYCIN_UP	P
NUTT_GBN_VS_AO_UP	NUTT_GBN_VS_AO_UP	P
BRENTANI_DNA_METHYLATION_AND_MODIFICATION	BRENTANI_DNA_METHYLATION_AND_MODIFICATION	P
MRNA_PROCESSING	MRNA_PROCESSING	P
EIF4PATHWAY	EIF4PATHWAY	P
CDK5PATHWAY	CDK5PATHWAY	P
AGUIRRE_PANCREAS_CHR22	AGUIRRE_PANCREAS_CHR22	P
VANTVEER_BREAST_OUTCOME_GOOD_VS_POOR_DN	VANTVEER_BREAST_OUTCOME_GOOD_VS_POOR_DN	P
CHANG_SERUM_RESPONSE_DN	CHANG_SERUM_RESPONSE_DN	P
BIOGENIC_AMINE_SYNTHESIS	BIOGENIC_AMINE_SYNTHESIS	P
SA_PROGRAMMED_CELL_DEATH	SA_PROGRAMMED_CELL_DEATH	P
CHAUVIN_ANDROGEN_REGULATED_GENES	CHAUVIN_ANDROGEN_REGULATED_GENES	P
EPONFKBPATHWAY	EPONFKBPATHWAY	P
BRENTANI_REPAIR	BRENTANI_REPAIR	P
HADDAD_HSC_CD10_UP	HADDAD_HSC_CD10_UP	P
PAR1PATHWAY	PAR1PATHWAY	P
FERNANDEZ_MYC_TARGETS	FERNANDEZ_MYC_TARGETS	P
IL2RBPATHWAY	IL2RBPATHWAY	P
PEART_HISTONE_UP	PEART_HISTONE_UP	P
SIG_BCR_SIGNALING_PATHWAY	SIG_BCR_SIGNALING_PATHWAY	P
MTORPATHWAY	MTORPATHWAY	P
EIF2PATHWAY	EIF2PATHWAY	P
AHSPPATHWAY	AHSPPATHWAY	P
PROLIFERATION_GENES	PROLIFERATION_GENES	P
BASSO_REGULATORY_HUBS	BASSO_REGULATORY_HUBS	P
FIBRINOLYSISPATHWAY	FIBRINOLYSISPATHWAY	P
MEF2DPATHWAY	MEF2DPATHWAY	P
TOLLPATHWAY	TOLLPATHWAY	P
KIM_TH_CELLS_UP	KIM_TH_CELLS_UP	P
HIFPATHWAY	HIFPATHWAY	P
LIZUKA_L1_SM_G1	LIZUKA_L1_SM_G1	P
TGFBPATHWAY	TGFBPATHWAY	P
CSKPATHWAY	CSKPATHWAY	P
BETAOXIDATIONPATHWAY	BETAOXIDATIONPATHWAY	P
CHEOK_HDMTX_UP	CHEOK_HDMTX_UP	P
STRESSPATHWAY	STRESSPATHWAY	P
KERATAN_SULFATE_BIOSYNTHESIS	KERATAN_SULFATE_BIOSYNTHESIS	P
MUSCLE_MYOSIN	MUSCLE_MYOSIN	P
SANA_IFNG_ENDOTHELIAL_DN	SANA_IFNG_ENDOTHELIAL_DN	P
HOUSTIS_ROS	HOUSTIS_ROS	P
MAGRANGEAS_MULTIPLE_MYELOMA_IGL_VS_IGK_DN	MAGRANGEAS_MULTIPLE_MYELOMA_IGL_VS_IGK_DN	P
PEART_HISTONE_DN	PEART_HISTONE_DN	P
PASSERINI_OXIDATION	PASSERINI_OXIDATION	P
PASSERINI_ADHESION	PASSERINI_ADHESION	P
APOPTOSIS_GENMAPP	APOPTOSIS_GENMAPP	P
C21_STEROID_HORMONE_METABOLISM	C21_STEROID_HORMONE_METABOLISM	P
CAPROLACTAM_DEGRADATION	CAPROLACTAM_DEGRADATION	P
SETPATHWAY	SETPATHWAY	P
HCC_SURVIVAL_GOOD_VS_POOR_UP	HCC_SURVIVAL_GOOD_VS_POOR_UP	P
INSULIN_SIGNALING	INSULIN_SIGNALING	P
CHESLER_BRAIN_NEURAL_HIGH_GENES	CHESLER_BRAIN_NEURAL_HIGH_GENES	P
IL4PATHWAY	IL4PATHWAY	P
LEE_CIP_DN	LEE_CIP_DN	P
ROSS_FAB_M7	ROSS_FAB_M7	P
P53PATHWAY	P53PATHWAY	P
METHANE_METABOLISM	METHANE_METABOLISM	P
SA_BONE_MORPHOGENETIC	SA_BONE_MORPHOGENETIC	P
GALACTOSE_METABOLISM	GALACTOSE_METABOLISM	P
FERRANDO_TAL1_NEIGHBORS	FERRANDO_TAL1_NEIGHBORS	P
FLECHNER_KIDNEY_TRANSPLANT_REJECTION_DN	FLECHNER_KIDNEY_TRANSPLANT_REJECTION_DN	P
RASPATHWAY	RASPATHWAY	P
IL17PATHWAY	IL17PATHWAY	P
PPARGPATHWAY	PPARGPATHWAY	P
INTEGRINPATHWAY	INTEGRINPATHWAY	P
BRENTANI_ANGIOGENESIS	BRENTANI_ANGIOGENESIS	P
PENTOSE_PHOSPHATE_PATHWAY	PENTOSE_PHOSPHATE_PATHWAY	P
YAMA_RECURRENT_HCC_UP	YAMA_RECURRENT_HCC_UP	P
PROTEASOME_DEGRADATION	PROTEASOME_DEGRADATION	P
PGC	PGC	P
BYSTRYKH_HSC_BRAIN_CIS_GLOCUS	BYSTRYKH_HSC_BRAIN_CIS_GLOCUS	P
FXRPATHWAY	FXRPATHWAY	P
BRENTANI_CELL_CYCLE	BRENTANI_CELL_CYCLE	P
SHHPATHWAY	SHHPATHWAY	P
ASTON_DEPRESSION_UP	ASTON_DEPRESSION_UP	P
ST_WNT_CA2_CYCLIC_GMP_PATHWAY	ST_WNT_CA2_CYCLIC_GMP_PATHWAY	P
CYTOKINEPATHWAY	CYTOKINEPATHWAY	P
TYPE_III_SECRETION_SYSTEM	TYPE_III_SECRETION_SYSTEM	P
GOLDRATH_CYTOLYTIC	GOLDRATH_CYTOLYTIC	P
WONG_IFNA_HCC_RESISTANT_VS_SENSITIVE_DN	WONG_IFNA_HCC_RESISTANT_VS_SENSITIVE_DN	P
PASSERINI_INFLAMMATION	PASSERINI_INFLAMMATION	P
SHIPP_DLBCL_CURED_UP	SHIPP_DLBCL_CURED_UP	P
HINATA_NFKB_DN	HINATA_NFKB_DN	P
LIZUKA_G2_GR_G3	LIZUKA_G2_GR_G3	P
LIZUKA_L0_SM_L1	LIZUKA_L0_SM_L1	P
S1P_SIGNALING	S1P_SIGNALING	P
IFNAPATHWAY	IFNAPATHWAY	P
SHEPARD_CRASH_AND_BURN_MUT_VS_WT_UP	SHEPARD_CRASH_AND_BURN_MUT_VS_WT_UP	P
NING_COPD_DN	NING_COPD_DN	P
SANA_IFNG_ENDOTHELIAL_UP	SANA_IFNG_ENDOTHELIAL_UP	P
GLUTATHIONE_METABOLISM	GLUTATHIONE_METABOLISM	P
GLOBOSIDE_METABOLISM	GLOBOSIDE_METABOLISM	P
BRENTANI_CANCER_TESTIS	BRENTANI_CANCER_TESTIS	P
KREBPATHWAY	KREBPATHWAY	P
CORDERO_KRAS_KD_VS_CONTROL_UP	CORDERO_KRAS_KD_VS_CONTROL_UP	P
CELL_MOTILITY	CELL_MOTILITY	P
YEN_MYC_MUT	YEN_MYC_MUT	P
SPPAPATHWAY	SPPAPATHWAY	P
NOTCHPATHWAY	NOTCHPATHWAY	P
RADIATION_SENSITIVITY	RADIATION_SENSITIVITY	P
AGUIRRE_PANCREAS_CHR19	AGUIRRE_PANCREAS_CHR19	P
SYNTHESIS_AND_DEGRADATION_OF_KETONE_BODIES	SYNTHESIS_AND_DEGRADATION_OF_KETONE_BODIES	P
LIN_WNT_UP	LIN_WNT_UP	P
DAVIES_MGUS_MM	DAVIES_MGUS_MM	P
POMEROY_MD_TREATMENT_GOOD_VS_POOR_DN	POMEROY_MD_TREATMENT_GOOD_VS_POOR_DN	P
PYK2PATHWAY	PYK2PATHWAY	P
BRENTANI_HORMONAL_FUNCTION	BRENTANI_HORMONAL_FUNCTION	P
DER_IFNG_UP	DER_IFNG_UP	P
GAMMA_HEXACHLOROCYCLOHEXANE_DEGRADATION	GAMMA_HEXACHLOROCYCLOHEXANE_DEGRADATION	P
CXCR4PATHWAY	CXCR4PATHWAY	P
FLUMAZENILPATHWAY	FLUMAZENILPATHWAY	P
KREBS_TCA_CYCLE	KREBS_TCA_CYCLE	P
MRNA_BINDING_ACTIVITY	MRNA_BINDING_ACTIVITY	P
CYSTEINE_METABOLISM	CYSTEINE_METABOLISM	P
CALCINEURINPATHWAY	CALCINEURINPATHWAY	P
BENZOATE_DEGRADATION_VIA_COA_LIGATION	BENZOATE_DEGRADATION_VIA_COA_LIGATION	P
IL5PATHWAY	IL5PATHWAY	P
GLEEVECPATHWAY	GLEEVECPATHWAY	P
ACETAMINOPHENPATHWAY	ACETAMINOPHENPATHWAY	P
IL22BPPATHWAY	IL22BPPATHWAY	P
SIG_IL4RECEPTOR_IN_B_LYPHOCYTES	SIG_IL4RECEPTOR_IN_B_LYPHOCYTES	P
GPCRS_CLASS_B_SECRETIN_LIKE	GPCRS_CLASS_B_SECRETIN_LIKE	P
SHEPARD_GENES_COMMON_BW_CB_MO	SHEPARD_GENES_COMMON_BW_CB_MO	P
BECKER_IFN_INDUCIBLE_SUBSET_1	BECKER_IFN_INDUCIBLE_SUBSET_1	P
CROONQUIST_RAS_STROMA_UP	CROONQUIST_RAS_STROMA_UP	P
ST_JAK_STAT_PATHWAY	ST_JAK_STAT_PATHWAY	P
PENTOSE_AND_GLUCURONATE_INTERCONVERSIONS	PENTOSE_AND_GLUCURONATE_INTERCONVERSIONS	P
LEE_DENA_DN	LEE_DENA_DN	P
EDG1PATHWAY	EDG1PATHWAY	P
CELL_GROWTH_AND_OR_MAINTENANCE	CELL_GROWTH_AND_OR_MAINTENANCE	P
FLECHNER_KIDNEY_TRANSPLANT_REJECTION_PBL_DN	FLECHNER_KIDNEY_TRANSPLANT_REJECTION_PBL_DN	P
BLOOD_GROUP_GLYCOLIPID_BIOSYNTHESIS_NEOLACTOSERIES	BLOOD_GROUP_GLYCOLIPID_BIOSYNTHESIS_NEOLACTOSERIES	P
CCR5PATHWAY	CCR5PATHWAY	P
SIG_CHEMOTAXIS	SIG_CHEMOTAXIS	P
RACCYCDPATHWAY	RACCYCDPATHWAY	P
EGF_RECEPTOR_SIGNALING_PATHWAY	EGF_RECEPTOR_SIGNALING_PATHWAY	P
ST_STAT3_PATHWAY	ST_STAT3_PATHWAY	P
ST_TUMOR_NECROSIS_FACTOR_PATHWAY	ST_TUMOR_NECROSIS_FACTOR_PATHWAY	P
TRNA_SYNTHETASES	TRNA_SYNTHETASES	P
BILE_ACID_BIOSYNTHESIS	BILE_ACID_BIOSYNTHESIS	P
DER_IFNG_DN	DER_IFNG_DN	P
RHOPATHWAY	RHOPATHWAY	P
HCC_SURVIVAL_GOOD_VS_POOR_DN	HCC_SURVIVAL_GOOD_VS_POOR_DN	P
OXIDATIVE_PHOSPHORYLATION	OXIDATIVE_PHOSPHORYLATION	P
VIPPATHWAY	VIPPATHWAY	P
SIG_REGULATION_OF_THE_ACTIN_CYTOSKELETON_BY_RHO_GTPASES	SIG_REGULATION_OF_THE_ACTIN_CYTOSKELETON_BY_RHO_GTPASES	P
BCL2_FAMILY_AND_REG_NETWORK	BCL2_FAMILY_AND_REG_NETWORK	P
HINATA_NFKB_UP	HINATA_NFKB_UP	P
NING_COPD_UP	NING_COPD_UP	P
BRENTANI_CELL_ADHESION	BRENTANI_CELL_ADHESION	P
FLECHNER_KIDNEY_TRANSPLANT_WELL_UP	FLECHNER_KIDNEY_TRANSPLANT_WELL_UP	P
TARTE_PC	TARTE_PC	P
PENG_LEUCINE_UP	PENG_LEUCINE_UP	P
HDACPATHWAY	HDACPATHWAY	P
PEPIPATHWAY	PEPIPATHWAY	P
CELL_SURFACE_RECEPTOR_LINKED_SIGNAL_TRANSDUCTION	CELL_SURFACE_RECEPTOR_LINKED_SIGNAL_TRANSDUCTION	P
TENEDINI_MEGAKARYOCYTIC_GENES	TENEDINI_MEGAKARYOCYTIC_GENES	P
GLYCOLYSIS	GLYCOLYSIS	P
CHESLER_D6MIT150_CIS_GLOCUS	CHESLER_D6MIT150_CIS_GLOCUS	P
GLYCOGEN_METABOLISM	GLYCOGEN_METABOLISM	P
JECHLINGER_EMT_UP	JECHLINGER_EMT_UP	P
POMEROY_MD_TREATMENT_GOOD_VS_POOR_UP	POMEROY_MD_TREATMENT_GOOD_VS_POOR_UP	P
PENG_GLUTAMINE_UP	PENG_GLUTAMINE_UP	P
AKTPATHWAY	AKTPATHWAY	P
DNA_POLYMERASE	DNA_POLYMERASE	P
LEE_MYC_E2F1_UP	LEE_MYC_E2F1_UP	P
P35ALZHEIMERSPATHWAY	P35ALZHEIMERSPATHWAY	P
ST_MYOCYTE_AD_PATHWAY	ST_MYOCYTE_AD_PATHWAY	P
LYSINE_DEGRADATION	LYSINE_DEGRADATION	P
GPCRDB_CLASS_C_METABOTROPIC_GLUTAMATE_PHEROMONE	GPCRDB_CLASS_C_METABOTROPIC_GLUTAMATE_PHEROMONE	P
GRANDVAUX_IRF3_DN	GRANDVAUX_IRF3_DN	P
STANELLE_E2F1_UP	STANELLE_E2F1_UP	P
GABAPATHWAY	GABAPATHWAY	P
ATMPATHWAY	ATMPATHWAY	P
FETAL_LIVER_VS_ADULT_LIVER_GNF2	FETAL_LIVER_VS_ADULT_LIVER_GNF2	P
ASBCELLPATHWAY	ASBCELLPATHWAY	P
ASTIER_BCELL	ASTIER_BCELL	P
FLECHNER_KIDNEY_TRANSPLANT_WELL_PBL_UP	FLECHNER_KIDNEY_TRANSPLANT_WELL_PBL_UP	P
AGUIRRE_PANCREAS_CHR18	AGUIRRE_PANCREAS_CHR18	P
PASSERINI_TRANSCRIPTION	PASSERINI_TRANSCRIPTION	P
MRNA_SPLICING	MRNA_SPLICING	P
CLASSICPATHWAY	CLASSICPATHWAY	P
VALINE_LEUCINE_AND_ISOLEUCINE_DEGRADATION	VALINE_LEUCINE_AND_ISOLEUCINE_DEGRADATION	P
IL2PATHWAY	IL2PATHWAY	P
OVARIAN_INFERTILITY_GENES	OVARIAN_INFERTILITY_GENES	P
IGF1RPATHWAY	IGF1RPATHWAY	P
BRENTANI_IMMUNE_FUNCTION	BRENTANI_IMMUNE_FUNCTION	P
TOB1PATHWAY	TOB1PATHWAY	P
AGUIRRE_PANCREAS_CHR17	AGUIRRE_PANCREAS_CHR17	P
BYSTROM_IL5_UP	BYSTROM_IL5_UP	P
ZUCCHI_EPITHELIAL_DN	ZUCCHI_EPITHELIAL_DN	P
FRUCTOSE_AND_MANNOSE_METABOLISM	FRUCTOSE_AND_MANNOSE_METABOLISM	P
PROPANOATE_METABOLISM	PROPANOATE_METABOLISM	P
ELECTRON_TRANSPORT	ELECTRON_TRANSPORT	P
BYSTROM_IL5_DN	BYSTROM_IL5_DN	P
CHEOK_LDMTX_MP_DN	CHEOK_LDMTX_MP_DN	P
NTHIPATHWAY	NTHIPATHWAY	P
MTA3PATHWAY	MTA3PATHWAY	P
LIZUKA_L0_GR_L1	LIZUKA_L0_GR_L1	P
PASSERINI_SIGNAL	PASSERINI_SIGNAL	P
TCAPOPTOSISPATHWAY	TCAPOPTOSISPATHWAY	P
ST_P38_MAPK_PATHWAY	ST_P38_MAPK_PATHWAY	P
ICHIBA_GVHD	ICHIBA_GVHD	P
CELL_CYCLE_KEGG	CELL_CYCLE_KEGG	P
ARENRF2PATHWAY	ARENRF2PATHWAY	P
WELCSH_BRCA_UP	WELCSH_BRCA_UP	P
LEE_ACOX1_DN	LEE_ACOX1_DN	P
PENG_GLUCOSE_DN	PENG_GLUCOSE_DN	P
COMPLEMENT_ACTIVATION_CLASSICAL	COMPLEMENT_ACTIVATION_CLASSICAL	P
PELP1PATHWAY	PELP1PATHWAY	P
ST_JNK_MAPK_PATHWAY	ST_JNK_MAPK_PATHWAY	P
ST_TYPE_I_INTERFERON_PATHWAY	ST_TYPE_I_INTERFERON_PATHWAY	P
FBW7PATHWAY	FBW7PATHWAY	P
FOSBPATHWAY	FOSBPATHWAY	P
NGFPATHWAY	NGFPATHWAY	P
GRAEBER_BETA2_INTEGRINS	GRAEBER_BETA2_INTEGRINS	P
NICOTINATE_AND_NICOTINAMIDE_METABOLISM	NICOTINATE_AND_NICOTINAMIDE_METABOLISM	P
ETSPATHWAY	ETSPATHWAY	P
NKTPATHWAY	NKTPATHWAY	P
SKP2E2FPATHWAY	SKP2E2FPATHWAY	P
WONG_IFNA_HCC_RESISTANT_VS_SENSITIVE_UP	WONG_IFNA_HCC_RESISTANT_VS_SENSITIVE_UP	P
DORSAM_HOXA9_DN	DORSAM_HOXA9_DN	P
ST_GA13_PATHWAY	ST_GA13_PATHWAY	P
ROSS_CBF	ROSS_CBF	P
JISON_SICKLE_CELL	JISON_SICKLE_CELL	P
SHIPP_FL_VS_DLBCL_UP	SHIPP_FL_VS_DLBCL_UP	P
IL6PATHWAY	IL6PATHWAY	P
NFATPATHWAY	NFATPATHWAY	P
CROONQUIST_IL6_STARVE_UP	CROONQUIST_IL6_STARVE_UP	P
EEA1PATHWAY	EEA1PATHWAY	P
UEDA_MOUSE_SCN	UEDA_MOUSE_SCN	P
LEE_MYC_DN	LEE_MYC_DN	P
DER_IFNA_UP	DER_IFNA_UP	P
STAT3PATHWAY	STAT3PATHWAY	P
ST_G_ALPHA_I_PATHWAY	ST_G_ALPHA_I_PATHWAY	P
KANNAN_P53_DN	KANNAN_P53_DN	P
MATRIX_METALLOPROTEINASES	MATRIX_METALLOPROTEINASES	P
TRANSLATION_FACTORS	TRANSLATION_FACTORS	P
PTDINSPATHWAY	PTDINSPATHWAY	P
LAMB_CYCLIN_D3_GLOCUS	LAMB_CYCLIN_D3_GLOCUS	P
PS1PATHWAY	PS1PATHWAY	P
FMLPPATHWAY	FMLPPATHWAY	P
NFKBPATHWAY	NFKBPATHWAY	P
PENG_GLUCOSE_UP	PENG_GLUCOSE_UP	P
MANALO_HYPOXIA_DN	MANALO_HYPOXIA_DN	P
KLEIN_PEL_UP	KLEIN_PEL_UP	P
ACTINYPATHWAY	ACTINYPATHWAY	P
SHIPP_DLBCL_CURED_DN	SHIPP_DLBCL_CURED_DN	P
BOTULINPATHWAY	BOTULINPATHWAY	P
ST_PAC1_RECEPTOR_PATHWAY	ST_PAC1_RECEPTOR_PATHWAY	P
P53HYPOXIAPATHWAY	P53HYPOXIAPATHWAY	P
G1PATHWAY	G1PATHWAY	P
GSK3PATHWAY	GSK3PATHWAY	P
TGF_BETA_SIGNALING_PATHWAY	TGF_BETA_SIGNALING_PATHWAY	P
CELL_CYCLE_CHECKPOINT	CELL_CYCLE_CHECKPOINT	P
PHENYLALANINE_TYROSINE_AND_TRYPTOPHAN_BIOSYNTHESIS	PHENYLALANINE_TYROSINE_AND_TRYPTOPHAN_BIOSYNTHESIS	P
SCHUMACHER_MYC_UP	SCHUMACHER_MYC_UP	P
LYMPHOCYTEPATHWAY	LYMPHOCYTEPATHWAY	P
BECKER_ESTROGEN_RESPONSIVE_SUBSET_2	BECKER_ESTROGEN_RESPONSIVE_SUBSET_2	P
FCER1PATHWAY	FCER1PATHWAY	P
ROS	ROS	P
ASCORBATE_AND_ALDARATE_METABOLISM	ASCORBATE_AND_ALDARATE_METABOLISM	P
ST_ERK1_ERK2_MAPK_PATHWAY	ST_ERK1_ERK2_MAPK_PATHWAY	P
INFLAMMATORY_RESPONSE_PATHWAY	INFLAMMATORY_RESPONSE_PATHWAY	P
SMALL_LIGAND_GPCRS	SMALL_LIGAND_GPCRS	P
RADAEVA_IFNA_DN	RADAEVA_IFNA_DN	P
ROSS_CBF_MYH	ROSS_CBF_MYH	P
UNDERHILL_PROLIFERATION	UNDERHILL_PROLIFERATION	P
REDUCTIVE_CARBOXYLATE_CYCLE_CO2_FIXATION	REDUCTIVE_CARBOXYLATE_CYCLE_CO2_FIXATION	P
MITOCHONDRIAL_FATTY_ACID_BETAOXIDATION	MITOCHONDRIAL_FATTY_ACID_BETAOXIDATION	P
GPCRDB_OTHER	GPCRDB_OTHER	P
SANA_TNFA_ENDOTHELIAL_DN	SANA_TNFA_ENDOTHELIAL_DN	P
BECKER_TAMOXIFEN_RESISTANT_UP	BECKER_TAMOXIFEN_RESISTANT_UP	P
BRENTANI_TRANSPORT_OF_VESICLES	BRENTANI_TRANSPORT_OF_VESICLES	P
CHESLER_D6MIT150_NEURAL_TARGETS_GLOCUS	CHESLER_D6MIT150_NEURAL_TARGETS_GLOCUS	P
CHONDROITIN	CHONDROITIN	P
LEE_ACOX1_UP	LEE_ACOX1_UP	P
CHESLER_HIGHEST_FOLD_RANGE_GENES	CHESLER_HIGHEST_FOLD_RANGE_GENES	P
ONE_CARBON_POOL_BY_FOLATE	ONE_CARBON_POOL_BY_FOLATE	P
SIG_CD40PATHWAYMAP	SIG_CD40PATHWAYMAP	P
G_PROTEIN_SIGNALING	G_PROTEIN_SIGNALING	P
EGFPATHWAY	EGFPATHWAY	P
CELL_PROLIFERATION	CELL_PROLIFERATION	P
ABRAHAM_MM_VS_AL_UP	ABRAHAM_MM_VS_AL_UP	P
ACE_INHIBITOR_PATHWAY_PHARMGKB	ACE_INHIBITOR_PATHWAY_PHARMGKB	P
ETCPATHWAY	ETCPATHWAY	P
D4GDIPATHWAY	D4GDIPATHWAY	P
ST_IL_13_PATHWAY	ST_IL_13_PATHWAY	P
CTLA4PATHWAY	CTLA4PATHWAY	P
MONOAMINE_GPCRS	MONOAMINE_GPCRS	P
PROTEASOME	PROTEASOME	P
KERATINOCYTEPATHWAY	KERATINOCYTEPATHWAY	P
CHEOK_HDMTX_DN	CHEOK_HDMTX_DN	P
BYSTRYKH_FLI1_TARGETS_GLOCUS	BYSTRYKH_FLI1_TARGETS_GLOCUS	P
ST_WNT_BETA_CATENIN_PATHWAY	ST_WNT_BETA_CATENIN_PATHWAY	P
FREEPATHWAY	FREEPATHWAY	P
FASPATHWAY	FASPATHWAY	P
SARSPATHWAY	SARSPATHWAY	P
TNFR1PATHWAY	TNFR1PATHWAY	P
MAGRANGEAS_MULTIPLE_MYELOMA_IGG_VS_IGA_UP	MAGRANGEAS_MULTIPLE_MYELOMA_IGG_VS_IGA_UP	P
TCRAPATHWAY	TCRAPATHWAY	P
CALCINEURIN_NF_AT_SIGNALING	CALCINEURIN_NF_AT_SIGNALING	P
MONOCYTEPATHWAY	MONOCYTEPATHWAY	P
PMLPATHWAY	PMLPATHWAY	P
CELL_CYCLE_ARREST	CELL_CYCLE_ARREST	P
SHEPARD_CRASH_AND_BURN_MUT_VS_WT_DN	SHEPARD_CRASH_AND_BURN_MUT_VS_WT_DN	P
IRINOTECAN_PATHWAY_PHARMGKB	IRINOTECAN_PATHWAY_PHARMGKB	P
GPCRS_CLASS_C_METABOTROPIC_GLUTAMATE_PHEROMONE	GPCRS_CLASS_C_METABOTROPIC_GLUTAMATE_PHEROMONE	P
ST_ADRENERGIC	ST_ADRENERGIC	P
DAVIES_N	DAVIES_N	P
IGF1PATHWAY	IGF1PATHWAY	P
ST_GA12_PATHWAY	ST_GA12_PATHWAY	P
STEMPATHWAY	STEMPATHWAY	P
LEE_MYC_E2F1_DN	LEE_MYC_E2F1_DN	P
HADDAD_HSC_CD7_UP	HADDAD_HSC_CD7_UP	P
GPCRDB_CLASS_A_RHODOPSIN_LIKE2	GPCRDB_CLASS_A_RHODOPSIN_LIKE2	P
TERCPATHWAY	TERCPATHWAY	P
CELL_CYCLE	CELL_CYCLE	P
FOLATE_BIOSYNTHESIS	FOLATE_BIOSYNTHESIS	P
SCHUMACHER_MYC_DN	SCHUMACHER_MYC_DN	P
BECKER_CANCER_ASSOCIATED_SUBSET_2	BECKER_CANCER_ASSOCIATED_SUBSET_2	P
BLOOD_GROUP_GLYCOLIPID_BIOSYNTHESIS_LACTOSERIES	BLOOD_GROUP_GLYCOLIPID_BIOSYNTHESIS_LACTOSERIES	P
SA_FAS_SIGNALING	SA_FAS_SIGNALING	P
LYSINE_BIOSYNTHESIS	LYSINE_BIOSYNTHESIS	P
LIZUKA_G2_SM_G3	LIZUKA_G2_SM_G3	P
GPCRPATHWAY	GPCRPATHWAY	P
CROONQUIST_IL6_STROMA_UP	CROONQUIST_IL6_STROMA_UP	P
VITCBPATHWAY	VITCBPATHWAY	P
TUMOR_SUPRESSOR	TUMOR_SUPRESSOR	P
DORSAM_HOXA9_UP	DORSAM_HOXA9_UP	P
ST_INTERLEUKIN_13_PATHWAY	ST_INTERLEUKIN_13_PATHWAY	P
DCPATHWAY	DCPATHWAY	P
MAPKPATHWAY	MAPKPATHWAY	P
BETA_ALANINE_METABOLISM	BETA_ALANINE_METABOLISM	P
LEPTINPATHWAY	LEPTINPATHWAY	P
IONPATHWAY	IONPATHWAY	P
FATTY_ACID_SYNTHESIS	FATTY_ACID_SYNTHESIS	P
PENG_LEUCINE_DN	PENG_LEUCINE_DN	P
ERK5PATHWAY	ERK5PATHWAY	P
CHESLER_BRAIN_HIGHEST_VARIANCE_GENES	CHESLER_BRAIN_HIGHEST_VARIANCE_GENES	P
PHOTOSYNTHESIS	PHOTOSYNTHESIS	P
EGFR_SMRTEPATHWAY	EGFR_SMRTEPATHWAY	P
ST_GRANULE_CELL_SURVIVAL_PATHWAY	ST_GRANULE_CELL_SURVIVAL_PATHWAY	P
SA_TRKA_RECEPTOR	SA_TRKA_RECEPTOR	P
SMITH_HTERT_UP	SMITH_HTERT_UP	P
MITOCHONDRIA	MITOCHONDRIA	P
CIRCADIAN_EXERCISE	CIRCADIAN_EXERCISE	P
NUCLEAR_RECEPTORS	NUCLEAR_RECEPTORS	P
ZHAN_TONSIL_PCBC	ZHAN_TONSIL_PCBC	P
EICOSANOID_SYNTHESIS	EICOSANOID_SYNTHESIS	P
AT1RPATHWAY	AT1RPATHWAY	P
HEMATOPOESIS_RELATED_TRANSCRIPTION_FACTORS	HEMATOPOESIS_RELATED_TRANSCRIPTION_FACTORS	P
ST_FAS_SIGNALING_PATHWAY	ST_FAS_SIGNALING_PATHWAY	P
FERRANDO_LYL1_NEIGHBORS	FERRANDO_LYL1_NEIGHBORS	P
BBCELLPATHWAY	BBCELLPATHWAY	P
SALMONELLAPATHWAY	SALMONELLAPATHWAY	P
SA_G2_AND_M_PHASES	SA_G2_AND_M_PHASES	P
GSPATHWAY	GSPATHWAY	P
ELECTRON_TRANSPORTER_ACTIVITY	ELECTRON_TRANSPORTER_ACTIVITY	P
WNTPATHWAY	WNTPATHWAY	P
GLYCOGEN	GLYCOGEN	P
CELL_ADHESION	CELL_ADHESION	P
UCALPAINPATHWAY	UCALPAINPATHWAY	P
TRYPTOPHAN_METABOLISM	TRYPTOPHAN_METABOLISM	P
PLCPATHWAY	PLCPATHWAY	P
RIBOFLAVIN_METABOLISM	RIBOFLAVIN_METABOLISM	P
LIZUKA_G1_SM_G2	LIZUKA_G1_SM_G2	P
RNA_TRANSCRIPTION_REACTOME	RNA_TRANSCRIPTION_REACTOME	P
LEE_MYC_UP	LEE_MYC_UP	P
JECHLINGER_EMT_DN	JECHLINGER_EMT_DN	P
WELCH_GATA1	WELCH_GATA1	P
PARKINPATHWAY	PARKINPATHWAY	P
MITOCHONDRIAPATHWAY	MITOCHONDRIAPATHWAY	P
NEUTROPHILPATHWAY	NEUTROPHILPATHWAY	P
P38MAPKPATHWAY	P38MAPKPATHWAY	P
LEE_MYC_TGFA_UP	LEE_MYC_TGFA_UP	P
RABPATHWAY	RABPATHWAY	P
ST_INTEGRIN_SIGNALING_PATHWAY	ST_INTEGRIN_SIGNALING_PATHWAY	P
PASSERINI_IMMUNE	PASSERINI_IMMUNE	P
BLYMPHOCYTEPATHWAY	BLYMPHOCYTEPATHWAY	P
PROSTAGLANDIN_SYNTHESIS_REGULATION	PROSTAGLANDIN_SYNTHESIS_REGULATION	P
SMITH_HTERT_DN	SMITH_HTERT_DN	P
DNA_REPLICATION_REACTOME	DNA_REPLICATION_REACTOME	P
BLOOD_CLOTTING_CASCADE	BLOOD_CLOTTING_CASCADE	P
MRNA_PROCESSING_REACTOME	MRNA_PROCESSING_REACTOME	P
CIRCADIANPATHWAY	CIRCADIANPATHWAY	P
GLYCEROPHOSPHOLIPID_METABOLISM	GLYCEROPHOSPHOLIPID_METABOLISM	P
CELL_CYCLE_CHECKPOINT_II	CELL_CYCLE_CHECKPOINT_II	P
CELLCYCLEPATHWAY	CELLCYCLEPATHWAY	P
ST_INTERFERON_GAMMA_PATHWAY	ST_INTERFERON_GAMMA_PATHWAY	P
ZUCCHI_EPITHELIAL_UP	ZUCCHI_EPITHELIAL_UP	P
G13_SIGNALING_PATHWAY	G13_SIGNALING_PATHWAY	P
MALATEXPATHWAY	MALATEXPATHWAY	P
ARAPPATHWAY	ARAPPATHWAY	P
FETAL_LIVER_ENRICHED_TRANSCRIPTION_FACTORS	FETAL_LIVER_ENRICHED_TRANSCRIPTION_FACTORS	P
BRENTANI_TRANSPORT	BRENTANI_TRANSPORT	P
GOLDRATH_CELLCYCLE	GOLDRATH_CELLCYCLE	P
PLCDPATHWAY	PLCDPATHWAY	P
GATA3PATHWAY	GATA3PATHWAY	P
BYSTRYKH_RUNX1_TARGETS_GLOCUS	BYSTRYKH_RUNX1_TARGETS_GLOCUS	P
TERPENOID_BIOSYNTHESIS	TERPENOID_BIOSYNTHESIS	P
REN_E2F1_TARGETS	REN_E2F1_TARGETS	P
BRENTANI_SIGNALING	BRENTANI_SIGNALING	P
TUBBYPATHWAY	TUBBYPATHWAY	P
UREACYCLEPATHWAY	UREACYCLEPATHWAY	P
ST_B_CELL_ANTIGEN_RECEPTOR	ST_B_CELL_ANTIGEN_RECEPTOR	P
RELAPATHWAY	RELAPATHWAY	P
MSPPATHWAY	MSPPATHWAY	P
LE_MYELIN_DN	LE_MYELIN_DN	P
ECMPATHWAY	ECMPATHWAY	P
TIDPATHWAY	TIDPATHWAY	P
GLYCOLYSIS_AND_GLUCONEOGENESIS	GLYCOLYSIS_AND_GLUCONEOGENESIS	P
POMEROY_DESMOPLASIC_VS_CLASSIC_MD_UP	POMEROY_DESMOPLASIC_VS_CLASSIC_MD_UP	P
STILBENE_COUMARINE_AND_LIGNIN_BIOSYNTHESIS	STILBENE_COUMARINE_AND_LIGNIN_BIOSYNTHESIS	P
P27PATHWAY	P27PATHWAY	P
PANTOTHENATE_AND_COA_BIOSYNTHESIS	PANTOTHENATE_AND_COA_BIOSYNTHESIS	P
FRASOR_ER_DN	FRASOR_ER_DN	P
SMOOTH_MUSCLE_CONTRACTION	SMOOTH_MUSCLE_CONTRACTION	P
PITX2PATHWAY	PITX2PATHWAY	P
CELL_DEATH	CELL_DEATH	P
RANKLPATHWAY	RANKLPATHWAY	P
UREA_CYCLE_AND_METABOLISM_OF_AMINO_GROUPS	UREA_CYCLE_AND_METABOLISM_OF_AMINO_GROUPS	P
LAIRPATHWAY	LAIRPATHWAY	P
GOLDRATH_HP	GOLDRATH_HP	P
LIMONENE_AND_PINENE_DEGRADATION	LIMONENE_AND_PINENE_DEGRADATION	P
FERRANDO_T_CELL_DIFFERENTIATION_PATHWAY	FERRANDO_T_CELL_DIFFERENTIATION_PATHWAY	P
OKUMURA_MC_LPS	OKUMURA_MC_LPS	P
ROSS_PML_RAR	ROSS_PML_RAR	P
CHESLER_BRAIN_ONLY_SUBSET	CHESLER_BRAIN_ONLY_SUBSET	P
ROSS_MLL_FUSION	ROSS_MLL_FUSION	P
GNATENKO_PLATELET	GNATENKO_PLATELET	P
LU_IL4BCELL	LU_IL4BCELL	P
RARRXRPATHWAY	RARRXRPATHWAY	P
PASSERINI_GROWTH	PASSERINI_GROWTH	P
41BBPATHWAY	41BBPATHWAY	P
RBPATHWAY	RBPATHWAY	P
ST_DICTYOSTELIUM_DISCOIDEUM_CAMP_CHEMOTAXIS_PATHWAY	ST_DICTYOSTELIUM_DISCOIDEUM_CAMP_CHEMOTAXIS_PATHWAY	P
SANA_TNFA_ENDOTHELIAL_UP	SANA_TNFA_ENDOTHELIAL_UP	P
LEE_E2F1_DN	LEE_E2F1_DN	P
AKAP13PATHWAY	AKAP13PATHWAY	P
ATRBRCAPATHWAY	ATRBRCAPATHWAY	P
GLUTAMATE_METABOLISM	GLUTAMATE_METABOLISM	P
NDKDYNAMINPATHWAY	NDKDYNAMINPATHWAY	P
HOGERKORP_ANTI_CD44_DN	HOGERKORP_ANTI_CD44_DN	P
DNAFRAGMENTPATHWAY	DNAFRAGMENTPATHWAY	P
SLRPPATHWAY	SLRPPATHWAY	P
CHEOK_LDMTX_MP_UP	CHEOK_LDMTX_MP_UP	P
G1_TO_S_CELL_CYCLE_REACTOME	G1_TO_S_CELL_CYCLE_REACTOME	P
NKCELLSPATHWAY	NKCELLSPATHWAY	P
LAMB_CYCLIN_D1_UP	LAMB_CYCLIN_D1_UP	P
YAGI_AML_PROGNOSIS	YAGI_AML_PROGNOSIS	P
VALINE_LEUCINE_AND_ISOLEUCINE_BIOSYNTHESIS	VALINE_LEUCINE_AND_ISOLEUCINE_BIOSYNTHESIS	P
STARCH_AND_SUCROSE_METABOLISM	STARCH_AND_SUCROSE_METABOLISM	P
PORPHYRIN_AND_CHLOROPHYLL_METABOLISM	PORPHYRIN_AND_CHLOROPHYLL_METABOLISM	P
S1PPATHWAY	S1PPATHWAY	P
AMIPATHWAY	AMIPATHWAY	P
CELL_ADHESION_MOLECULE_ACTIVITY	CELL_ADHESION_MOLECULE_ACTIVITY	P
ALANINE_AND_ASPARTATE_METABOLISM	ALANINE_AND_ASPARTATE_METABOLISM	P
SELENOAMINO_ACID_METABOLISM	SELENOAMINO_ACID_METABOLISM	P
WILLERT_WNT_NCCIT_ALL_UP	WILLERT_WNT_NCCIT_ALL_UP	P
CELL_ADHESION_RECEPTOR_ACTIVITY	CELL_ADHESION_RECEPTOR_ACTIVITY	P
ST_G_ALPHA_S_PATHWAY	ST_G_ALPHA_S_PATHWAY	P
MYOSINPATHWAY	MYOSINPATHWAY	P
CHEOK_MP_DN	CHEOK_MP_DN	P
TCRPATHWAY	TCRPATHWAY	P
YEN_MYC_WT	YEN_MYC_WT	P
TCYTOTOXICPATHWAY	TCYTOTOXICPATHWAY	P
BYSTRYKH_HSC_TRANS_GLOCUS	BYSTRYKH_HSC_TRANS_GLOCUS	P
TRKAPATHWAY	TRKAPATHWAY	P
ANDROGEN_GENES	ANDROGEN_GENES	P
ASTON_DEPRESSION_DN	ASTON_DEPRESSION_DN	P
CHANG_SERUM_RESPONSE_UP	CHANG_SERUM_RESPONSE_UP	P
CASPASE_ACTIVITY	CASPASE_ACTIVITY	P
CREBPATHWAY	CREBPATHWAY	P
ZELLER_MYC_UP	ZELLER_MYC_UP	P
KENNY_WNT_UP	KENNY_WNT_UP	P
TERTPATHWAY	TERTPATHWAY	P
SA_G1_AND_S_PHASES	SA_G1_AND_S_PHASES	P
AGUIRRE_PANCREAS_CHR7	AGUIRRE_PANCREAS_CHR7	P
CERAMIDEPATHWAY	CERAMIDEPATHWAY	P
EXTRINSICPATHWAY	EXTRINSICPATHWAY	P
LEI_HOXC8_UP	LEI_HOXC8_UP	P
ZHAN_TONSIL_BONEMARROW	ZHAN_TONSIL_BONEMARROW	P
CELL2CELLPATHWAY	CELL2CELLPATHWAY	P
GOLDRATH_MEMORY	GOLDRATH_MEMORY	P
SHEPARD_POS_REG_OF_CELL_PROLIFERATION	SHEPARD_POS_REG_OF_CELL_PROLIFERATION	P
ROSS_AML1_ETO	ROSS_AML1_ETO	P
1_AND_2_METHYLNAPHTHALENE_DEGRADATION	1_AND_2_METHYLNAPHTHALENE_DEGRADATION	P
BECKER_CANCER_ASSOCIATED_SUBSET_1	BECKER_CANCER_ASSOCIATED_SUBSET_1	P
NUCLEOTIDE_GPCRS	NUCLEOTIDE_GPCRS	P
GHPATHWAY	GHPATHWAY	P
TESTIS_EXPRESSED_GENES	TESTIS_EXPRESSED_GENES	P
TPOPATHWAY	TPOPATHWAY	P
ASTON_OLIGODENDROGLIA_MYELINATION_SUBSET	ASTON_OLIGODENDROGLIA_MYELINATION_SUBSET	P
GPCRS_CLASS_A_RHODOPSIN_LIKE_2	GPCRS_CLASS_A_RHODOPSIN_LIKE_2	P
CHREBPPATHWAY	CHREBPPATHWAY	P
PTENPATHWAY	PTENPATHWAY	P
CROONQUIST_IL6_RAS_DN	CROONQUIST_IL6_RAS_DN	P
MAGRANGEAS_MULTIPLE_MYELOMA_IGL_VS_IGK_UP	MAGRANGEAS_MULTIPLE_MYELOMA_IGL_VS_IGK_UP	P
BRENTANI_TRANSCRIPTION_FACTORS	BRENTANI_TRANSCRIPTION_FACTORS	P
FATTY_ACID_BIOSYNTHESIS_PATH_2	FATTY_ACID_BIOSYNTHESIS_PATH_2	P
TARTE_BCELL	TARTE_BCELL	P
NEUROTRANSMITTERSPATHWAY	NEUROTRANSMITTERSPATHWAY	P
ARGININECPATHWAY	ARGININECPATHWAY	P
WELCSH_BRCA_DN	WELCSH_BRCA_DN	P
VEGFPATHWAY	VEGFPATHWAY	P
CDC25PATHWAY	CDC25PATHWAY	P
MARSHALL_SPLEEN_BAL	MARSHALL_SPLEEN_BAL	P
BRENTANI_PROTEIN_MODIFICATION	BRENTANI_PROTEIN_MODIFICATION	P
PDGFPATHWAY	PDGFPATHWAY	P
MUNSHI_MM_UP	MUNSHI_MM_UP	P
ST_GAQ_PATHWAY	ST_GAQ_PATHWAY	P
CYANOAMINO_ACID_METABOLISM	CYANOAMINO_ACID_METABOLISM	P
POMEROY_DESMOPLASIC_VS_CLASSIC_MD_DN	POMEROY_DESMOPLASIC_VS_CLASSIC_MD_DN	P
NO2IL12PATHWAY	NO2IL12PATHWAY	P
LEI_HOXC8_DN	LEI_HOXC8_DN	P
PARK_HSC_VS_MPP_UP	PARK_HSC_VS_MPP_UP	P
MOOTHA_VOXPHOS	MOOTHA_VOXPHOS	P
FEEDERPATHWAY	FEEDERPATHWAY	P
RAC1PATHWAY	RAC1PATHWAY	P
DREAMPATHWAY	DREAMPATHWAY	P
STURLA_SONIC_HEDGEHOG	STURLA_SONIC_HEDGEHOG	P
TH1TH2PATHWAY	TH1TH2PATHWAY	P
P53_SIGNALING	P53_SIGNALING	P
LEE_MYC_TGFA_DN	LEE_MYC_TGFA_DN	P
PPARAPATHWAY	PPARAPATHWAY	P
N_GLYCAN_DEGRADATION	N_GLYCAN_DEGRADATION	P
SHEPARD_BMYB_MORPHOLINO_UP	SHEPARD_BMYB_MORPHOLINO_UP	P
SIG_PIP3_SIGNALING_IN_CARDIAC_MYOCTES	SIG_PIP3_SIGNALING_IN_CARDIAC_MYOCTES	P
CASPASEPATHWAY	CASPASEPATHWAY	P
NUCLEOTIDE_SUGARS_METABOLISM	NUCLEOTIDE_SUGARS_METABOLISM	P
CELL_CYCLE_REGULATOR	CELL_CYCLE_REGULATOR	P
GLYOXYLATE_AND_DICARBOXYLATE_METABOLISM	GLYOXYLATE_AND_DICARBOXYLATE_METABOLISM	P
IL10PATHWAY	IL10PATHWAY	P
APOPTOSIS	APOPTOSIS	P
PROTEASOMEPATHWAY	PROTEASOMEPATHWAY	P
COLLER_MYC_UP	COLLER_MYC_UP	P
CREMPATHWAY	CREMPATHWAY	P
BIOPEPTIDESPATHWAY	BIOPEPTIDESPATHWAY	P
VANTVEER_BREAST_OUTCOME_GOOD_VS_POOR_UP	VANTVEER_BREAST_OUTCOME_GOOD_VS_POOR_UP	P
TYROSINE_METABOLISM	TYROSINE_METABOLISM	P
BRENTANI_DEATH	BRENTANI_DEATH	P
ARFPATHWAY	ARFPATHWAY	P
LEE_DENA_UP	LEE_DENA_UP	P
CHEOK_MP_UP	CHEOK_MP_UP	P
CHOLESTEROL_BIOSYNTHESIS	CHOLESTEROL_BIOSYNTHESIS	P
UBIQUITIN_MEDIATED_PROTEOLYSIS	UBIQUITIN_MEDIATED_PROTEOLYSIS	P
NELSON_ANDROGEN_UP	NELSON_ANDROGEN_UP	P
ST_INTERLEUKIN_4_PATHWAY	ST_INTERLEUKIN_4_PATHWAY	P
FATTY_ACID_DEGRADATION	FATTY_ACID_DEGRADATION	P
BECKER_TAMOXIFEN_RESISTANT_DN	BECKER_TAMOXIFEN_RESISTANT_DN	P
COMPPATHWAY	COMPPATHWAY	P
HADDAD_HSC_CD7_DN	HADDAD_HSC_CD7_DN	P
CHESLER_BRAIN_TRANS_GENES	CHESLER_BRAIN_TRANS_GENES	P
TAKEDA_NUP8_HOXA9_8D_UP	TAKEDA_NUP8_HOXA9_8D_UP	P
YAO_P4_KO_VS_WT_UP	YAO_P4_KO_VS_WT_UP	P
HOFFMANN_BIVSBII_LGBII	HOFFMANN_BIVSBII_LGBII	P
KNUDSEN_PMNS_DN	KNUDSEN_PMNS_DN	P
TAKEDA_NUP8_HOXA9_8D_DN	TAKEDA_NUP8_HOXA9_8D_DN	P
ALCALAY_AML_NPMC_UP	ALCALAY_AML_NPMC_UP	P
ZHAN_MM_CD1_VS_CD2_UP	ZHAN_MM_CD1_VS_CD2_UP	P
KRETZSCHMAR_IL6_DIFF	KRETZSCHMAR_IL6_DIFF	P
ADDYA_K562_HEMIN_TREATMENT	ADDYA_K562_HEMIN_TREATMENT	P
GALINDO_ACT_UP	GALINDO_ACT_UP	P
ZHAN_MULTIPLE_MYELOMA_SUBCLASSES_DIFF	ZHAN_MULTIPLE_MYELOMA_SUBCLASSES_DIFF	P
XU_CBP_DN	XU_CBP_DN	P
LEE_TCELLS10_UP	LEE_TCELLS10_UP	P
LINDSTEDT_DEND_UP	LINDSTEDT_DEND_UP	P
NADLER_OBESITY_DN	NADLER_OBESITY_DN	P
ROTH_HTERT_DIFF	ROTH_HTERT_DIFF	P
SCHURINGA_STAT5A_UP	SCHURINGA_STAT5A_UP	P
BOQUEST_CD31PLUS_VS_CD31MINUS_DN	BOQUEST_CD31PLUS_VS_CD31MINUS_DN	P
YU_CMYC_DN	YU_CMYC_DN	P
HESS_HOXAANMEIS1_UP	HESS_HOXAANMEIS1_UP	P
NGUYEN_KERATO_DN	NGUYEN_KERATO_DN	P
HSIAO_LIVER_SPECIFIC_GENES	HSIAO_LIVER_SPECIFIC_GENES	P
ZHAN_MULTIPLE_MYELOMA_VS_NORMAL_UP	ZHAN_MULTIPLE_MYELOMA_VS_NORMAL_UP	P
HASLINGER_B_CLL_12	HASLINGER_B_CLL_12	P
MOREAUX_TACI_HI_IN_PPC_UP	MOREAUX_TACI_HI_IN_PPC_UP	P
HOFFMANN_BIVSBII_IMVM	HOFFMANN_BIVSBII_IMVM	P
HESS_HOXAANMEIS1_DN	HESS_HOXAANMEIS1_DN	P
WANG_HOXA9_VS_MEIS1_DN	WANG_HOXA9_VS_MEIS1_DN	P
RORIE_ES_PNET_DN	RORIE_ES_PNET_DN	P
LINDSTEDT_DEND_8H_VS_48H_DN	LINDSTEDT_DEND_8H_VS_48H_DN	P
GALE_FLT3ANDAPL_DN	GALE_FLT3ANDAPL_DN	P
RUIZ_TENASCIN_TARGETS	RUIZ_TENASCIN_TARGETS	P
GNATENKO_PLATELET_UP	GNATENKO_PLATELET_UP	P
ZHAN_MM_CD138_HP_VS_REST	ZHAN_MM_CD138_HP_VS_REST	P
GERY_CEBP_TARGETS	GERY_CEBP_TARGETS	P
GALE_FLT3ANDAPL_UP	GALE_FLT3ANDAPL_UP	P
NUMATA_G_CSF_DIFF	NUMATA_G_CSF_DIFF	P
IGLESIAS_E2FMINUS_UP	IGLESIAS_E2FMINUS_UP	P
LIAN_MYELOID_DIFF_GRANULE	LIAN_MYELOID_DIFF_GRANULE	P
HADDAD_HPCLYMPHO_ENRICHED	HADDAD_HPCLYMPHO_ENRICHED	P
HOGERKORP_CD44_UP	HOGERKORP_CD44_UP	P
BASSO_HCL_DIFF	BASSO_HCL_DIFF	P
SANSOM_APC_4_DN	SANSOM_APC_4_DN	P
ZHAN_MM_CD1_VS_CD2_DN	ZHAN_MM_CD1_VS_CD2_DN	P
MOREAUX_TACI_HI_VS_LOW_DN	MOREAUX_TACI_HI_VS_LOW_DN	P
HADDAD_CD45CD7_PLUS_VS_MINUS_DN	HADDAD_CD45CD7_PLUS_VS_MINUS_DN	P
RUTELLA_HEPATGFSNDCS_UP	RUTELLA_HEPATGFSNDCS_UP	P
KANG_TERT_DN	KANG_TERT_DN	P
LEE_TCELLS6_UP	LEE_TCELLS6_UP	P
LEE_TCELLS8_UP	LEE_TCELLS8_UP	P
WANG_HOXA9_VS_MEIS1_UP	WANG_HOXA9_VS_MEIS1_UP	P
JISON_SICKLECELL_DIFF	JISON_SICKLECELL_DIFF	P
RORIE_ES_PNET_UP	RORIE_ES_PNET_UP	P
PARK_MSCS_DIFF	PARK_MSCS_DIFF	P
VANASSE_BCL2_TARGETS	VANASSE_BCL2_TARGETS	P
LEE_TCELLS4_UP	LEE_TCELLS4_UP	P
KAMMINGA_EZH2_TARGETS	KAMMINGA_EZH2_TARGETS	P
LEE_TCELLS7_UP	LEE_TCELLS7_UP	P
HOGERKORP_CD44_DN	HOGERKORP_CD44_DN	P
ZHAN_MM_CD138_CD1_VS_REST	ZHAN_MM_CD138_CD1_VS_REST	P
LIAN_MYELOID_DIFF_TF	LIAN_MYELOID_DIFF_TF	P
MARTINELLI_IFNS_DIFF	MARTINELLI_IFNS_DIFF	P
MARCINIAK_CHOP_DIFF	MARCINIAK_CHOP_DIFF	P
LINDSTEDT_DEND_8H_VS_48H_UP	LINDSTEDT_DEND_8H_VS_48H_UP	P
JAIN_NEMO_DIFF	JAIN_NEMO_DIFF	P
HOHENKIRK_MONOCYTE_DEND_UP	HOHENKIRK_MONOCYTE_DEND_UP	P
RADMACHER_AMLNORMALKARYTYPE_SIG	RADMACHER_AMLNORMALKARYTYPE_SIG	P
HASLINGER_B_CLL_11Q23	HASLINGER_B_CLL_11Q23	P
PARK_RARALPHA_MOD	PARK_RARALPHA_MOD	P
MA_ATRA_EMP_DN	MA_ATRA_EMP_DN	P
MATSUDA_VALPHAINKT_DIFF	MATSUDA_VALPHAINKT_DIFF	P
HOHENKIRK_MONOCYTE_DEND_DN	HOHENKIRK_MONOCYTE_DEND_DN	P
MENSE_HYPOXIA_DN	MENSE_HYPOXIA_DN	P
BROWN_GRAN_MONO_DIFFERENTIATION	BROWN_GRAN_MONO_DIFFERENTIATION	P
ZHAN_PCS_MULTIPLE_MYELOMA_SPKD	ZHAN_PCS_MULTIPLE_MYELOMA_SPKD	P
ABBUD_LIF_DN	ABBUD_LIF_DN	P
RUTELLA_HEMATOGFSNDCS_DIFF	RUTELLA_HEMATOGFSNDCS_DIFF	P
ZHAN_MM_CD138_CD2_VS_REST	ZHAN_MM_CD138_CD2_VS_REST	P
PARK_MSCS_LIN2	PARK_MSCS_LIN2	P
HALMOS_CEBP_DN	HALMOS_CEBP_DN	P
XU_ATRA_DN	XU_ATRA_DN	P
APPEL_IMATINIB_UP	APPEL_IMATINIB_UP	P
GREENBAUM_E2A_DN	GREENBAUM_E2A_DN	P
LINDSTEDT_DEND_DN	LINDSTEDT_DEND_DN	P
ALCALAY_AML_NPMC_DN	ALCALAY_AML_NPMC_DN	P
MOREAUX_TACI_BAFF_DN	MOREAUX_TACI_BAFF_DN	P
NEMETH_TNF_UP	NEMETH_TNF_UP	P
MUNSHI_MM_VS_PCS_UP	MUNSHI_MM_VS_PCS_UP	P
LEE_TCELLS1_UP	LEE_TCELLS1_UP	P
TAKEDA_NUP8_HOXA9_3D_DN	TAKEDA_NUP8_HOXA9_3D_DN	P
ZHAN_MMPC_EARLYVS	ZHAN_MMPC_EARLYVS	P
SANSOM_APC_LOSS4_UP	SANSOM_APC_LOSS4_UP	P
ZHANG_EFT_EWSFLI1_UP	ZHANG_EFT_EWSFLI1_UP	P
CHIARETTI_ZAP70_DIFF	CHIARETTI_ZAP70_DIFF	P
NOUZOVA_CPG_METHLTD	NOUZOVA_CPG_METHLTD	P
HOGERKORP_CD44_TEMPORALLY_DN	HOGERKORP_CD44_TEMPORALLY_DN	P
NADLER_OBESITY_HYPERGLYCEMIA	NADLER_OBESITY_HYPERGLYCEMIA	P
TAKEDA_NUP8_HOXA9_3D_UP	TAKEDA_NUP8_HOXA9_3D_UP	P
DORSEY_DOXYCYCLINE_UP	DORSEY_DOXYCYCLINE_UP	P
MOREAUX_TACI_XG_13_UP	MOREAUX_TACI_XG_13_UP	P
LEE_TCELLS2_UP	LEE_TCELLS2_UP	P
VERHAAK_AML_NPM1_MUT_VS_WT_UP	VERHAAK_AML_NPM1_MUT_VS_WT_UP	P
ZHAN_MM_MOLECULAR_CLASSI_UP	ZHAN_MM_MOLECULAR_CLASSI_UP	P
CHEN_HOXA5_TARGETS_DN	CHEN_HOXA5_TARGETS_DN	P
FALT_BCLL_UP	FALT_BCLL_UP	P
PARK_MSCS_BOTH	PARK_MSCS_BOTH	P
LEE_TCELLS3_UP	LEE_TCELLS3_UP	P
IRITANI_ADPROX_UP	IRITANI_ADPROX_UP	P
VERNELL_PRB_CLSTR2	VERNELL_PRB_CLSTR2	P
PARK_RARALPHA_UP	PARK_RARALPHA_UP	P
FERRANDO_MLL_T_ALL_DN	FERRANDO_MLL_T_ALL_DN	P
BASSO_GERMINAL_CENTER_CD40_UP	BASSO_GERMINAL_CENTER_CD40_UP	P
STEFFEN_AML_PML_PLZF_TRGT	STEFFEN_AML_PML_PLZF_TRGT	P
ZHAN_MM_CD138_PR_VS_REST	ZHAN_MM_CD138_PR_VS_REST	P
MENSE_HYPOXIA_UP	MENSE_HYPOXIA_UP	P
MOREAUX_TACI_BAFF_UP	MOREAUX_TACI_BAFF_UP	P
SANSOM_APC_5_DN	SANSOM_APC_5_DN	P
XU_ATRA_UP	XU_ATRA_UP	P
FALT_BCLL_IG_MUTATED_VS_WT_DN	FALT_BCLL_IG_MUTATED_VS_WT_DN	P
STOSSI_ER_UP	STOSSI_ER_UP	P
VERHAAK_AML_NPM1_MUT_VS_WT_DN	VERHAAK_AML_NPM1_MUT_VS_WT_DN	P
ASTIER_FN_DIFF	ASTIER_FN_DIFF	P
HEDVAT_ELF_UP	HEDVAT_ELF_UP	P
NAKAJIMA_MCSMBP_MAST	NAKAJIMA_MCSMBP_MAST	P
TAVOR_CEBP_DN	TAVOR_CEBP_DN	P
GAY_YY1_UP	GAY_YY1_UP	P
MA_ATRA_EMP_UP	MA_ATRA_EMP_UP	P
GREENBAUM_E2A_UP	GREENBAUM_E2A_UP	P
VERNELL_PRB_CLSTR1	VERNELL_PRB_CLSTR1	P
KUMAR_HOXA_DIFF	KUMAR_HOXA_DIFF	P
XU_ATRA_PLUSNSC_UP	XU_ATRA_PLUSNSC_UP	P
LIAN_MYELOID_DIFF_RECEPTORS	LIAN_MYELOID_DIFF_RECEPTORS	P
YAGI_AML_PROG_ASSOC	YAGI_AML_PROG_ASSOC	P
BENNETT_SLE_UP	BENNETT_SLE_UP	P
GUO_HEX_UP	GUO_HEX_UP	P
NOUZOVA_CPG_H4_UP	NOUZOVA_CPG_H4_UP	P
HANSON_NFKAPPB_IND	HANSON_NFKAPPB_IND	P
MENSE_HYPOXIA_TRANSPORTER_GENES	MENSE_HYPOXIA_TRANSPORTER_GENES	P
GUO_HEX_DN	GUO_HEX_DN	P
GILDEA_BLADDER_UP	GILDEA_BLADDER_UP	P
HADDAD_CD45CD7_PLUS_VS_MINUS_UP	HADDAD_CD45CD7_PLUS_VS_MINUS_UP	P
NGUYEN_KERATO_UP	NGUYEN_KERATO_UP	P
WANG_MLL_CBP_VS_GMP_UP	WANG_MLL_CBP_VS_GMP_UP	P
FALT_BCLL_IG_MUTATED_VS_WT_UP	FALT_BCLL_IG_MUTATED_VS_WT_UP	P
ZHAN_MMPC_SIM	ZHAN_MMPC_SIM	P
IRITANI_ADPROX_LYMPH	IRITANI_ADPROX_LYMPH	P
ABRAHAM_AL_VS_MM_UP	ABRAHAM_AL_VS_MM_UP	P
LI_FETAL_VS_WT_KIDNEY_DN	LI_FETAL_VS_WT_KIDNEY_DN	P
ROTH_HTERT_UP	ROTH_HTERT_UP	P
KNUDSEN_PMNS_UP	KNUDSEN_PMNS_UP	P
ZHAN_MMPC_LATEVS	ZHAN_MMPC_LATEVS	P
TAKEDA_NUP8_HOXA9_6H_DN	TAKEDA_NUP8_HOXA9_6H_DN	P
HEDVAT_ELF_DN	HEDVAT_ELF_DN	P
HASLINGER_B_CLL_17P13	HASLINGER_B_CLL_17P13	P
HOFMANN_MANTEL_LYMPHOMA_VS_LYMPH_NODES_DN	HOFMANN_MANTEL_LYMPHOMA_VS_LYMPH_NODES_DN	P
MOREAUX_TACI_HI_VS_LOW_UP	MOREAUX_TACI_HI_VS_LOW_UP	P
MENSE_HYPOXIA_APOPTOSIS_GENES	MENSE_HYPOXIA_APOPTOSIS_GENES	P
SCHURINGA_STAT5A_DN	SCHURINGA_STAT5A_DN	P
HOFFMANN_BIVSBII_BI_TABLE2	HOFFMANN_BIVSBII_BI_TABLE2	P
STAEGE_EFTS_UP	STAEGE_EFTS_UP	P
ABBUD_LIF_GH3_DN	ABBUD_LIF_GH3_DN	P
MOREAUX_TACI_HI_IN_BMPC	MOREAUX_TACI_HI_IN_BMPC	P
ABBUD_LIF_UP	ABBUD_LIF_UP	P
YANG_OSTECLASTS_SIG	YANG_OSTECLASTS_SIG	P
TAKEDA_NUP8_HOXA9_16D_UP	TAKEDA_NUP8_HOXA9_16D_UP	P
LEI_MYB_REGULATED_GENES	LEI_MYB_REGULATED_GENES	P
HOGERKORP_CD44_TEMPORALLY_UP	HOGERKORP_CD44_TEMPORALLY_UP	P
NAKAJIMA_MCSMBP_EOS	NAKAJIMA_MCSMBP_EOS	P
BASSO_GERMINAL_CENTER_CD40_DN	BASSO_GERMINAL_CENTER_CD40_DN	P
TAVOR_CEBP_UP	TAVOR_CEBP_UP	P
LEE_TCELLS5_UP	LEE_TCELLS5_UP	P
LEE_TCELLS9_UP	LEE_TCELLS9_UP	P
XU_CBP_UP	XU_CBP_UP	P
TAKEDA_NUP8_HOXA9_10D_DN	TAKEDA_NUP8_HOXA9_10D_DN	P
NICK_RHAPC_UP	NICK_RHAPC_UP	P
HOFFMANN_BIVSBII_BI	HOFFMANN_BIVSBII_BI	P
IGLESIAS_E2FMINUS_DN	IGLESIAS_E2FMINUS_DN	P
ZHAN_MM_MOLECULAR_CLASSI_DN	ZHAN_MM_MOLECULAR_CLASSI_DN	P
WALLACE_JAK2_DIFF	WALLACE_JAK2_DIFF	P
NEMETH_TNF_DN	NEMETH_TNF_DN	P
IRITANI_ADPROX_DN	IRITANI_ADPROX_DN	P
YU_CMYC_UP	YU_CMYC_UP	P
NAKAJIMA_MCS_UP	NAKAJIMA_MCS_UP	P
YAGI_AML_PROG_FAB	YAGI_AML_PROG_FAB	P
XU_ATRA_PLUSNSC_DN	XU_ATRA_PLUSNSC_DN	P
WANG_MLL_CBP_VS_GMP_DN	WANG_MLL_CBP_VS_GMP_DN	P
HOFMANN_MDS_CD34_LOW_RISK	HOFMANN_MDS_CD34_LOW_RISK	P
ROTH_HTERT_DN	ROTH_HTERT_DN	P
SANSOM_APC_LOSS5_UP	SANSOM_APC_LOSS5_UP	P
ZHAN_MULTIPLE_MYELOMA_VS_NORMAL_DN	ZHAN_MULTIPLE_MYELOMA_VS_NORMAL_DN	P
BROWN_MYELOID_PROLIF_AND_SELF_RENEWAL	BROWN_MYELOID_PROLIF_AND_SELF_RENEWAL	P
CHIARETTI_T_ALL_DIFF	CHIARETTI_T_ALL_DIFF	P
HOFMANN_MANTEL_LYMPHOMA_VS_LYMPH_NODES_UP	HOFMANN_MANTEL_LYMPHOMA_VS_LYMPH_NODES_UP	P
FALT_BCLL_DN	FALT_BCLL_DN	P
ZHAN_MM_CD138_LB_VS_REST	ZHAN_MM_CD138_LB_VS_REST	P
SCHRAETS_MLL_UP	SCHRAETS_MLL_UP	P
ZHAN_MMPC_SIM_BC_AND_MM	ZHAN_MMPC_SIM_BC_AND_MM	P
HASLINGER_B_CLL_MUTATED	HASLINGER_B_CLL_MUTATED	P
BOQUEST_CD31PLUS_VS_CD31MINUS_UP	BOQUEST_CD31PLUS_VS_CD31MINUS_UP	P
ZHAN_MMPC_SIMAL	ZHAN_MMPC_SIMAL	P
HASLINGER_B_CLL_13Q14	HASLINGER_B_CLL_13Q14	P
FLOTHO_CASP8AP2_MRD_DIFF	FLOTHO_CASP8AP2_MRD_DIFF	P
IRITANI_ADPROX_VASC	IRITANI_ADPROX_VASC	P
YAO_P4_KO_VS_WT_DN	YAO_P4_KO_VS_WT_DN	P
MOREAUX_TACI_XG_13_DN	MOREAUX_TACI_XG_13_DN	P
CROMER_HYPOPHARYNGEAL_MET_VS_NON_DN	CROMER_HYPOPHARYNGEAL_MET_VS_NON_DN	P
NADLER_OBESITY_UP	NADLER_OBESITY_UP	P
ZHAN_MMPC_PC	ZHAN_MMPC_PC	P
TAKEDA_NUP8_HOXA9_16D_DN	TAKEDA_NUP8_HOXA9_16D_DN	P
LI_FETAL_VS_WT_KIDNEY_UP	LI_FETAL_VS_WT_KIDNEY_UP	P
KANG_TERT_UP	KANG_TERT_UP	P
HALMOS_CEBP_UP	HALMOS_CEBP_UP	P
HOFMANN_MDS_CD34_LOW_AND_HIGH_RISK	HOFMANN_MDS_CD34_LOW_AND_HIGH_RISK	P
FERRARI_4HPR_UP	FERRARI_4HPR_UP	P
RAY_P210_DIFF	RAY_P210_DIFF	P
TAKEDA_NUP8_HOXA9_10D_UP	TAKEDA_NUP8_HOXA9_10D_UP	P
ZHAN_MM_CD138_MF_VS_REST	ZHAN_MM_CD138_MF_VS_REST	P
BRUNO_IL3_DN	BRUNO_IL3_DN	P
CROMER_HYPOPHARYNGEAL_MET_VS_NON_UP	CROMER_HYPOPHARYNGEAL_MET_VS_NON_UP	P
MUNSHI_MM_VS_PCS_DN	MUNSHI_MM_VS_PCS_DN	P
WALKER_MM_SNP_DIFF	WALKER_MM_SNP_DIFF	P
ABBUD_LIF_GH3_UP	ABBUD_LIF_GH3_UP	P
TAKEDA_NUP8_HOXA9_6H_UP	TAKEDA_NUP8_HOXA9_6H_UP	P
SASAKI_ATL_UP	SASAKI_ATL_UP	P
HASLINGER_B_CLL_6Q21	HASLINGER_B_CLL_6Q21	P
ZHAN_MM_CD138_MS_VS_REST	ZHAN_MM_CD138_MS_VS_REST	P
HOFMANN_MDS_CD34_HIGH_RISK	HOFMANN_MDS_CD34_HIGH_RISK	P
CHEN_HOXA5_TARGETS_UP	CHEN_HOXA5_TARGETS_UP	P
FERRANDO_MLL_T_ALL_UP	FERRANDO_MLL_T_ALL_UP	P
GAY_YY1_DN	GAY_YY1_DN	P
ABRAHAM_AL_VS_MM_DN	ABRAHAM_AL_VS_MM_DN	P
MYOD_NIH3T3_UP	MYOD_NIH3T3_UP	P
AGEING_KIDNEY_SPECIFIC_UP	AGEING_KIDNEY_SPECIFIC_UP	P
CREB_BRAIN_8WKS_UP	CREB_BRAIN_8WKS_UP	P
HBX_HEP_UP	HBX_HEP_UP	P
HDACI_COLON_TSA2HRS_UP	HDACI_COLON_TSA2HRS_UP	P
INSULIN_ADIP_SENS_UP	INSULIN_ADIP_SENS_UP	P
HSC_HSCANDPROGENITORS_SHARED	HSC_HSCANDPROGENITORS_SHARED	P
IRS_KO_ADIP_DN	IRS_KO_ADIP_DN	P
IL6_FIBRO_UP	IL6_FIBRO_UP	P
BLEO_HUMAN_LYMPH_HIGH_4HRS_UP	BLEO_HUMAN_LYMPH_HIGH_4HRS_UP	P
HDACI_COLON_CUR2HRS_UP	HDACI_COLON_CUR2HRS_UP	P
SHH_UP	SHH_UP	P
TPA_RESIST_LATE_DN	TPA_RESIST_LATE_DN	P
GH_EXOGENOUS_ALL_UP	GH_EXOGENOUS_ALL_UP	P
BUT_TSA_UP	BUT_TSA_UP	P
CARIES_PULP_HIGH_UP	CARIES_PULP_HIGH_UP	P
UVB_NHEK1_C1	UVB_NHEK1_C1	P
HDACI_COLON_BUT24HRS_UP	HDACI_COLON_BUT24HRS_UP	P
ICF_DN	ICF_DN	P
ADIPOGENESIS_HMSC_CLASS3_UP	ADIPOGENESIS_HMSC_CLASS3_UP	P
IGF1_NIH3T3_UP	IGF1_NIH3T3_UP	P
SARCOMAS_SYNOVIAL_DN	SARCOMAS_SYNOVIAL_DN	P
AGED_MOUSE_MUSCLE_UP	AGED_MOUSE_MUSCLE_UP	P
AGED_MOUSE_HIPPOCAMPUS_MULTI_UP	AGED_MOUSE_HIPPOCAMPUS_MULTI_UP	P
BRCA1_SW480_UP	BRCA1_SW480_UP	P
GENOTOXINS_4HRS_DISCR	GENOTOXINS_4HRS_DISCR	P
INNEREAR_UP	INNEREAR_UP	P
BRCA2_BRCA1_DN	BRCA2_BRCA1_DN	P
HIPPOCAMPUS_DEVELOPMENT_POSTNATAL	HIPPOCAMPUS_DEVELOPMENT_POSTNATAL	P
CPR_LOW_LIVER_DN	CPR_LOW_LIVER_DN	P
AGEING_KIDNEY_DN	AGEING_KIDNEY_DN	P
BCRABL_HL60_AFFY_UP	BCRABL_HL60_AFFY_UP	P
UV-CMV_UNIQUE_HCMV_6HRS_DN	UV-CMV_UNIQUE_HCMV_6HRS_DN	P
OLDAGE_DN	OLDAGE_DN	P
WERNERONLY_FIBRO_DN	WERNERONLY_FIBRO_DN	P
CANCER_NEOPLASTIC_META_UP	CANCER_NEOPLASTIC_META_UP	P
P21_P53_EARLY_DN	P21_P53_EARLY_DN	P
METHOTREXATE_PROBCELL_UP	METHOTREXATE_PROBCELL_UP	P
CMV_24HRS_UP	CMV_24HRS_UP	P
BCNU_GLIOMA_MGMT_24HRS_DN	BCNU_GLIOMA_MGMT_24HRS_DN	P
VEGF_MMMEC_3HRS_UP	VEGF_MMMEC_3HRS_UP	P
TPA_RESIST_MIDDLE_DN	TPA_RESIST_MIDDLE_DN	P
MYC_TARGETS	MYC_TARGETS	P
IGFR_IR_DN	IGFR_IR_DN	P
COCAINE_BRAIN_4WKS_UP	COCAINE_BRAIN_4WKS_UP	P
MMS_MOUSE_LYMPH_HIGH_24HRS_UP	MMS_MOUSE_LYMPH_HIGH_24HRS_UP	P
IDX_TSA_UP_CLUSTER6	IDX_TSA_UP_CLUSTER6	P
UVC_LOW_C3_DN	UVC_LOW_C3_DN	P
HSC_LATEPROGENITORS_SHARED	HSC_LATEPROGENITORS_SHARED	P
PREADIP_VS_FIBRO_UP	PREADIP_VS_FIBRO_UP	P
IFN_BETA_GLIOMA_DN	IFN_BETA_GLIOMA_DN	P
CAMPTOTHECIN_PROBCELL_UP	CAMPTOTHECIN_PROBCELL_UP	P
TNFA_NFKB_DEP_UP	TNFA_NFKB_DEP_UP	P
STEMCELL_EMBRYONIC_UP	STEMCELL_EMBRYONIC_UP	P
DAC_BLADDER_UP	DAC_BLADDER_UP	P
VEGF_HUVEC_30MIN_UP	VEGF_HUVEC_30MIN_UP	P
BCNU_GLIOMA_NOMGMT_48HRS_DN	BCNU_GLIOMA_NOMGMT_48HRS_DN	P
SERUM_FIBROBLAST_CORE_UP	SERUM_FIBROBLAST_CORE_UP	P
UV-4NQO_FIBRO_UP	UV-4NQO_FIBRO_UP	P
GH_AUTOCRINE_DN	GH_AUTOCRINE_DN	P
HDACI_COLON_SUL12HRS_DN	HDACI_COLON_SUL12HRS_DN	P
PLATELET_EXPRESSED	PLATELET_EXPRESSED	P
AGEING_BRAIN_UP	AGEING_BRAIN_UP	P
ERM_KO_TESTES_DN	ERM_KO_TESTES_DN	P
LVAD_HEARTFAILURE_DN	LVAD_HEARTFAILURE_DN	P
CIS_XPC_DN	CIS_XPC_DN	P
UVC_TTD_8HR_DN	UVC_TTD_8HR_DN	P
ADIPOGENESIS_HMSC_CLASS5_UP	ADIPOGENESIS_HMSC_CLASS5_UP	P
BRCA1_OVEREXP_PROSTATE_UP	BRCA1_OVEREXP_PROSTATE_UP	P
UVC_XPCS_ALL_DN	UVC_XPCS_ALL_DN	P
DIAB_NEPH_DN	DIAB_NEPH_DN	P
ET743PT650_COLONCA_DN	ET743PT650_COLONCA_DN	P
TCELL_ANERGIC_UP	TCELL_ANERGIC_UP	P
METASTASIS_ADENOCARC_DN	METASTASIS_ADENOCARC_DN	P
TPA_RESIST_EARLY_UP	TPA_RESIST_EARLY_UP	P
HDACI_COLON_TSA48HRS_UP	HDACI_COLON_TSA48HRS_UP	P
UVC_TTD_4HR_DN	UVC_TTD_4HR_DN	P
OXSTRESS_RPETWO_DN	OXSTRESS_RPETWO_DN	P
GH_HYPOPHYSECTOMY_RAT_DN	GH_HYPOPHYSECTOMY_RAT_DN	P
HDACI_COLON_CUR_DN	HDACI_COLON_CUR_DN	P
CMV-UV_HCMV_6HRS_DN	CMV-UV_HCMV_6HRS_DN	P
GENOTOXINS_24HRS_DISCR	GENOTOXINS_24HRS_DISCR	P
CMV_HCMV_TIMECOURSE_18HRS_DN	CMV_HCMV_TIMECOURSE_18HRS_DN	P
UVB_NHEK3_C8	UVB_NHEK3_C8	P
TPA_SKIN_UP	TPA_SKIN_UP	P
CPR_NULL-LOW_LIVER_UP	CPR_NULL-LOW_LIVER_UP	P
BCRABL_HL60_CDNA_DN	BCRABL_HL60_CDNA_DN	P
UVB_NHEK3_C5	UVB_NHEK3_C5	P
IFN_BETA_GLIOMA_UP	IFN_BETA_GLIOMA_UP	P
CMV_HCMV_TIMECOURSE_24HRS_UP	CMV_HCMV_TIMECOURSE_24HRS_UP	P
E2F1_DNA_UP	E2F1_DNA_UP	P
UVB_NHEK1_UP	UVB_NHEK1_UP	P
ROS_MOUSE_AORTA_UP	ROS_MOUSE_AORTA_UP	P
HSC_INTERMEDIATEPROGENITORS_FETAL	HSC_INTERMEDIATEPROGENITORS_FETAL	P
STRESS_GENOTOXIC_SPECIFIC_UP	STRESS_GENOTOXIC_SPECIFIC_UP	P
HDACI_COLON_SUL_UP	HDACI_COLON_SUL_UP	P
HEATSHOCK_YOUNG_UP	HEATSHOCK_YOUNG_UP	P
UVB_NHEK3_C2	UVB_NHEK3_C2	P
NI2_LUNG_DN	NI2_LUNG_DN	P
UVC_TTD_ALL_DN	UVC_TTD_ALL_DN	P
MOUSE_TISSUE_KIDNEY	MOUSE_TISSUE_KIDNEY	P
CMV_HCMV_TIMECOURSE_48HRS_DN	CMV_HCMV_TIMECOURSE_48HRS_DN	P
SARCOMAS_LIPOSARCOMA_DN	SARCOMAS_LIPOSARCOMA_DN	P
GAMMA-UV_FIBRO_DN	GAMMA-UV_FIBRO_DN	P
AS3_FIBRO_UP	AS3_FIBRO_UP	P
ADIPOCYTE_PPARG_UP	ADIPOCYTE_PPARG_UP	P
DNMT1_KO_DN	DNMT1_KO_DN	P
DAC_FIBRO_UP	DAC_FIBRO_UP	P
CMV_HCMV_TIMECOURSE_10HRS_DN	CMV_HCMV_TIMECOURSE_10HRS_DN	P
HBX_NL_DN	HBX_NL_DN	P
UV_UNIQUE_FIBRO_UP	UV_UNIQUE_FIBRO_UP	P
BRCA1KO_MEF_DN	BRCA1KO_MEF_DN	P
HBX_HCC_DN	HBX_HCC_DN	P
SARCOMAS_LEIOMYOSARCOMA_CALP_UP	SARCOMAS_LEIOMYOSARCOMA_CALP_UP	P
UVB_NHEK4_24HRS_DN	UVB_NHEK4_24HRS_DN	P
ESR_FIBROBLAST_DN	ESR_FIBROBLAST_DN	P
HYPERME_COLONCA_SW48	HYPERME_COLONCA_SW48	P
TGFBETA_C4_UP	TGFBETA_C4_UP	P
IDX_TSA_DN_CLUSTER3	IDX_TSA_DN_CLUSTER3	P
MOUSE_TISSUE_TESTIS	MOUSE_TISSUE_TESTIS	P
CMV_HCMV_TIMECOURSE_12HRS_UP	CMV_HCMV_TIMECOURSE_12HRS_UP	P
BRCA_ER_POS	BRCA_ER_POS	P
UV-CMV_UNIQUE_HCMV_6HRS_UP	UV-CMV_UNIQUE_HCMV_6HRS_UP	P
DSRNA_DN	DSRNA_DN	P
UVC_XPCS_4HR_UP	UVC_XPCS_4HR_UP	P
UVC_HIGH_D2_DN	UVC_HIGH_D2_DN	P
ADIPOGENESIS_HMSC_CLASS8_DN	ADIPOGENESIS_HMSC_CLASS8_DN	P
HBX_HCC_UP	HBX_HCC_UP	P
HPV31_DN	HPV31_DN	P
CITED1_KO_HET_UP	CITED1_KO_HET_UP	P
BRCA1_MES_UP	BRCA1_MES_UP	P
UVB_NHEK3_C7	UVB_NHEK3_C7	P
TPA_SENS_EARLY_DN	TPA_SENS_EARLY_DN	P
UVB_SCC_DN	UVB_SCC_DN	P
HSC_EARLYPROGENITORS_FETAL	HSC_EARLYPROGENITORS_FETAL	P
VLB_RES_XENOGRAFTS_UP	VLB_RES_XENOGRAFTS_UP	P
STEMCELL_COMMON_DN	STEMCELL_COMMON_DN	P
CMV_HCMV_TIMECOURSE_4HRS_DN	CMV_HCMV_TIMECOURSE_4HRS_DN	P
CMV_HCMV_TIMECOURSE_12HRS_DN	CMV_HCMV_TIMECOURSE_12HRS_DN	P
AGED_MOUSE_CORTEX_UP	AGED_MOUSE_CORTEX_UP	P
HDACI_COLON_TSABUT_DN	HDACI_COLON_TSABUT_DN	P
UVB_NHEK1_DN	UVB_NHEK1_DN	P
GH_GHRHR_KO_6HRS_DN	GH_GHRHR_KO_6HRS_DN	P
TSA_CD4_UP	TSA_CD4_UP	P
CREB_BRAIN_8WKS_DN	CREB_BRAIN_8WKS_DN	P
CMV_HCMV_TIMECOURSE_ALL_DN	CMV_HCMV_TIMECOURSE_ALL_DN	P
AGED_RHESUS_UP	AGED_RHESUS_UP	P
IFNALPHA_NL_HCC_UP	IFNALPHA_NL_HCC_UP	P
HDACI_COLON_BUT_UP	HDACI_COLON_BUT_UP	P
TSADAC_RKOSILENT_UP	TSADAC_RKOSILENT_UP	P
P53GENES_ALL	P53GENES_ALL	P
UVC_TTD-XPCS_COMMON_DN	UVC_TTD-XPCS_COMMON_DN	P
AD12_ANY_DN	AD12_ANY_DN	P
HSC_HSC_SHARED	HSC_HSC_SHARED	P
TSA_PANC50_UP	TSA_PANC50_UP	P
HDACI_COLON_BUT12HRS_UP	HDACI_COLON_BUT12HRS_UP	P
ELONGINA_KO_UP	ELONGINA_KO_UP	P
HDACI_COLON_BUT16HRS_DN	HDACI_COLON_BUT16HRS_DN	P
CMV_HCMV_TIMECOURSE_8HRS_UP	CMV_HCMV_TIMECOURSE_8HRS_UP	P
CANCER_UNDIFFERENTIATED_META_UP	CANCER_UNDIFFERENTIATED_META_UP	P
AGED_MOUSE_HYPOTH_UP	AGED_MOUSE_HYPOTH_UP	P
ALZHEIMERS_DISEASE_DN	ALZHEIMERS_DISEASE_DN	P
INOS_ALL_UP	INOS_ALL_UP	P
BRCA_ER_NEG	BRCA_ER_NEG	P
BLEO_MOUSE_LYMPH_HIGH_4HRS_UP	BLEO_MOUSE_LYMPH_HIGH_4HRS_UP	P
INSULIN_NIH3T3_UP	INSULIN_NIH3T3_UP	P
GH_EXOGENOUS_ANY_DN	GH_EXOGENOUS_ANY_DN	P
TPA_RESIST_EARLY_DN	TPA_RESIST_EARLY_DN	P
UVC_XPCS_ALL_UP	UVC_XPCS_ALL_UP	P
HYPOPHYSECTOMY_RAT_DN	HYPOPHYSECTOMY_RAT_DN	P
XPB_TTD-CS_DN	XPB_TTD-CS_DN	P
SARCOMAS_LIPOSARCOMA_UP	SARCOMAS_LIPOSARCOMA_UP	P
ICF_UP	ICF_UP	P
TPA_SENS_MIDDLE_DN	TPA_SENS_MIDDLE_DN	P
IL6_SCAR_FIBRO_UP	IL6_SCAR_FIBRO_UP	P
AS3_FIBRO_C1	AS3_FIBRO_C1	P
GN_CAMP_GRANULOSA_DN	GN_CAMP_GRANULOSA_DN	P
CIS_RESIST_LUNG_UP	CIS_RESIST_LUNG_UP	P
IDX_TSA_UP_CLUSTER5	IDX_TSA_UP_CLUSTER5	P
UVC_HIGH_D7_DN	UVC_HIGH_D7_DN	P
IGF_VS_PDGF_UP	IGF_VS_PDGF_UP	P
HYPOXIA_REVIEW	HYPOXIA_REVIEW	P
TNFALPHA_TGZ_ADIP_DN	TNFALPHA_TGZ_ADIP_DN	P
GAMMA_UNIQUE_FIBRO_DN	GAMMA_UNIQUE_FIBRO_DN	P
STRESS_P53_SPECIFIC_UP	STRESS_P53_SPECIFIC_UP	P
HDACI_COLON_CLUSTER7	HDACI_COLON_CLUSTER7	P
AGEING_KIDNEY_SPECIFIC_DN	AGEING_KIDNEY_SPECIFIC_DN	P
HDACI_COLON_TSA48HRS_DN	HDACI_COLON_TSA48HRS_DN	P
MYOD_NIH3T3_DN	MYOD_NIH3T3_DN	P
ADIPOCYTE_BRCA_UP	ADIPOCYTE_BRCA_UP	P
CORTEX_ENRICHMENT_EARLY_UP	CORTEX_ENRICHMENT_EARLY_UP	P
HTERT_DN	HTERT_DN	P
CALRES_RHESUS_DN	CALRES_RHESUS_DN	P
NI2_MOUSE_UP	NI2_MOUSE_UP	P
IFN_ALL_UP	IFN_ALL_UP	P
OXSTRESS_RPE_HNETBH_DN	OXSTRESS_RPE_HNETBH_DN	P
HDACI_COLON_BUT24HRS_DN	HDACI_COLON_BUT24HRS_DN	P
TSA_CD4_DN	TSA_CD4_DN	P
MTX_RES_XENOGRAFTS_UP	MTX_RES_XENOGRAFTS_UP	P
AS3_FIBRO_C3	AS3_FIBRO_C3	P
ALZHEIMERS_INCIPIENT_DN	ALZHEIMERS_INCIPIENT_DN	P
BRCA1_OVEREXP_DN	BRCA1_OVEREXP_DN	P
UVB_NHEK3_ALL	UVB_NHEK3_ALL	P
CPR_NULL_LIVER_DN	CPR_NULL_LIVER_DN	P
BAF57_BT549_UP	BAF57_BT549_UP	P
GH_GHRHR_KO_24HRS_DN	GH_GHRHR_KO_24HRS_DN	P
HDACI_COLON_SUL2HRS_DN	HDACI_COLON_SUL2HRS_DN	P
HDACI_COLON_SUL48HRS_UP	HDACI_COLON_SUL48HRS_UP	P
P21_ANY_UP	P21_ANY_UP	P
TGFBETA_C1_UP	TGFBETA_C1_UP	P
IFNALPHA_NL_UP	IFNALPHA_NL_UP	P
TNFALPHA_TGZ_ADIP_UP	TNFALPHA_TGZ_ADIP_UP	P
UVB_NHEK1_C6	UVB_NHEK1_C6	P
HUMAN_TISSUE_PANCREAS	HUMAN_TISSUE_PANCREAS	P
P21_P53_ANY_DN	P21_P53_ANY_DN	P
HDACI_COLON_BUT2HRS_UP	HDACI_COLON_BUT2HRS_UP	P
HYPOXIA_FIBRO_UP	HYPOXIA_FIBRO_UP	P
CALRES_MOUSE_NEOCORTEX_UP	CALRES_MOUSE_NEOCORTEX_UP	P
TSADAC_RKOEXP_UP	TSADAC_RKOEXP_UP	P
AGED_MOUSE_RETINA_ANY_DN	AGED_MOUSE_RETINA_ANY_DN	P
MMS_HUMAN_LYMPH_HIGH_24HRS_DN	MMS_HUMAN_LYMPH_HIGH_24HRS_DN	P
ALZHEIMERS_DISEASE_UP	ALZHEIMERS_DISEASE_UP	P
AGED_MOUSE_HIPPOCAMPUS_ANY_UP	AGED_MOUSE_HIPPOCAMPUS_ANY_UP	P
HSC_LATEPROGENITORS_FETAL	HSC_LATEPROGENITORS_FETAL	P
ET743_HELA_DN	ET743_HELA_DN	P
HIPPOCAMPUS_DEVELOPMENT_NEONATAL	HIPPOCAMPUS_DEVELOPMENT_NEONATAL	P
GH_AUTOCRINE_UP	GH_AUTOCRINE_UP	P
TSADAC_HYPERMETH_OVCA_UP	TSADAC_HYPERMETH_OVCA_UP	P
TGFBETA_C5_UP	TGFBETA_C5_UP	P
HSC_STHSC_FETAL	HSC_STHSC_FETAL	P
HUMAN_TISSUE_PLACENTA	HUMAN_TISSUE_PLACENTA	P
SARCOMAS_GISTROMAL_UP	SARCOMAS_GISTROMAL_UP	P
ET743_SARCOMA_24HRS_DN	ET743_SARCOMA_24HRS_DN	P
JNK_DN	JNK_DN	P
AGED_MOUSE_CEREBELLUM_UP	AGED_MOUSE_CEREBELLUM_UP	P
PARP_KO_UP	PARP_KO_UP	P
BLEO_HUMAN_LYMPH_HIGH_24HRS_UP	BLEO_HUMAN_LYMPH_HIGH_24HRS_UP	P
DAC_IFN_BLADDER_UP	DAC_IFN_BLADDER_UP	P
BRCA1_OVEREXP_PROSTATE_DN	BRCA1_OVEREXP_PROSTATE_DN	P
PITUITARY_FETAL_DN	PITUITARY_FETAL_DN	P
HYPOXIA_RCC_NOVHL_UP	HYPOXIA_RCC_NOVHL_UP	P
UVC_TTD_4HR_UP	UVC_TTD_4HR_UP	P
CMV-UV_HCMV_6HRS_UP	CMV-UV_HCMV_6HRS_UP	P
VEGF_MMMEC_ALL_UP	VEGF_MMMEC_ALL_UP	P
CMV_HCMV_TIMECOURSE_48HRS_UP	CMV_HCMV_TIMECOURSE_48HRS_UP	P
HDACI_COLON_SUL16HRS_UP	HDACI_COLON_SUL16HRS_UP	P
AD12_48HRS_DN	AD12_48HRS_DN	P
STRESS_TPA_SPECIFIC_UP	STRESS_TPA_SPECIFIC_UP	P
ET743_SARCOMA_48HRS_DN	ET743_SARCOMA_48HRS_DN	P
OLDONLY_FIBRO_UP	OLDONLY_FIBRO_UP	P
NF90_UP	NF90_UP	P
IDX_TSA_DN_CLUSTER5	IDX_TSA_DN_CLUSTER5	P
METHOTREXATE_PROBCELL_DN	METHOTREXATE_PROBCELL_DN	P
IGFR_IR_UP	IGFR_IR_UP	P
CIS_RESIST_LUNG_DN	CIS_RESIST_LUNG_DN	P
UVC_XPCS_8HR_DN	UVC_XPCS_8HR_DN	P
UVB_NHEK3_C0	UVB_NHEK3_C0	P
CPR_NULL_LIVER_UP	CPR_NULL_LIVER_UP	P
TPA_SKIN_DN	TPA_SKIN_DN	P
STRESS_GENOTOXIC_SPECIFIC_DN	STRESS_GENOTOXIC_SPECIFIC_DN	P
IDX_TSA_UP_CLUSTER1	IDX_TSA_UP_CLUSTER1	P
HYPOPHYSECTOMY_RAT_UP	HYPOPHYSECTOMY_RAT_UP	P
POD1_KO_MOST_DN	POD1_KO_MOST_DN	P
MMC_RES_XENOGRAFTS_UP	MMC_RES_XENOGRAFTS_UP	P
HIPPOCAMPUS_DEVELOPMENT_PRENATAL	HIPPOCAMPUS_DEVELOPMENT_PRENATAL	P
HDACI_COLON_SUL30MIN_DN	HDACI_COLON_SUL30MIN_DN	P
XPB_TTD-CS_UP	XPB_TTD-CS_UP	P
CITED1_KO_HET_DN	CITED1_KO_HET_DN	P
CMV_8HRS_UP	CMV_8HRS_UP	P
HDACI_COLON_BUT_DN	HDACI_COLON_BUT_DN	P
AGEING_KIDNEY_UP	AGEING_KIDNEY_UP	P
IDX_TSA_DN_CLUSTER4	IDX_TSA_DN_CLUSTER4	P
GH_EXOGENOUS_EARLY_DN	GH_EXOGENOUS_EARLY_DN	P
GH_EXOGENOUS_EARLY_UP	GH_EXOGENOUS_EARLY_UP	P
UVB_NHEK4_6HRS_DN	UVB_NHEK4_6HRS_DN	P
TSADAC_HYPOMETH_OVCA_UP	TSADAC_HYPOMETH_OVCA_UP	P
OXSTRESS_BREASTCA_DN	OXSTRESS_BREASTCA_DN	P
SARCOMAS_LEIOMYOSARCOMA_UP	SARCOMAS_LEIOMYOSARCOMA_UP	P
AS3_FIBRO_DN	AS3_FIBRO_DN	P
CMV_IE86_UP	CMV_IE86_UP	P
GH_EXOGENOUS_MIDDLE_UP	GH_EXOGENOUS_MIDDLE_UP	P
IFNA_HCMV_6HRS_UP	IFNA_HCMV_6HRS_UP	P
UVC_HIGH_D9_DN	UVC_HIGH_D9_DN	P
TZD_ADIP_DN	TZD_ADIP_DN	P
CMV_HCMV_TIMECOURSE_14HRS_UP	CMV_HCMV_TIMECOURSE_14HRS_UP	P
AGEING_BRAIN_DN	AGEING_BRAIN_DN	P
SARCOMAS_SYNOVIAL_UP	SARCOMAS_SYNOVIAL_UP	P
EGF_HDMEC_UP	EGF_HDMEC_UP	P
ADIP_HUMAN_DN	ADIP_HUMAN_DN	P
GAMMA_UNIQUE_FIBRO_UP	GAMMA_UNIQUE_FIBRO_UP	P
HDACI_COLON_CLUSTER6	HDACI_COLON_CLUSTER6	P
AS3_HEK293_UP	AS3_HEK293_UP	P
UVC_HIGH_ALL_DN	UVC_HIGH_ALL_DN	P
CORTEX_ENRICHMENT_LATE_UP	CORTEX_ENRICHMENT_LATE_UP	P
DIAB_NEPH_UP	DIAB_NEPH_UP	P
UVC_HIGH_D8_DN	UVC_HIGH_D8_DN	P
HDACI_COLON_CUR48HRS_UP	HDACI_COLON_CUR48HRS_UP	P
HSC_EARLYPROGENITORS_SHARED	HSC_EARLYPROGENITORS_SHARED	P
CANTHARIDIN_UP	CANTHARIDIN_UP	P
HDACI_COLON_CLUSTER5	HDACI_COLON_CLUSTER5	P
CANCERDRUGS_PROBCELL_DN	CANCERDRUGS_PROBCELL_DN	P
HDACI_COLON_CURSUL_DN	HDACI_COLON_CURSUL_DN	P
TPA_SENS_LATE_UP	TPA_SENS_LATE_UP	P
ATRIA_UP	ATRIA_UP	P
HG_PROGERIA_DN	HG_PROGERIA_DN	P
HSC_HSCANDPROGENITORS_ADULT	HSC_HSCANDPROGENITORS_ADULT	P
ADIP_HUMAN_UP	ADIP_HUMAN_UP	P
UVC_LOW_ALL_UP	UVC_LOW_ALL_UP	P
HTERT_UP	HTERT_UP	P
CALRES_MOUSE_DN	CALRES_MOUSE_DN	P
CIS_XPC_UP	CIS_XPC_UP	P
OXSTRESS_RPETHREE_DN	OXSTRESS_RPETHREE_DN	P
OLD_FIBRO_DN	OLD_FIBRO_DN	P
ROS_MOUSE_AORTA_DN	ROS_MOUSE_AORTA_DN	P
ADIP_DIFF_CLUSTER4	ADIP_DIFF_CLUSTER4	P
FSH_HUMAN_GRANULOSA_UP	FSH_HUMAN_GRANULOSA_UP	P
MYOD_BRG1_UP	MYOD_BRG1_UP	P
TSA_HEPATOMA_CANCER_UP	TSA_HEPATOMA_CANCER_UP	P
AGED_MOUSE_RETINA_ANY_UP	AGED_MOUSE_RETINA_ANY_UP	P
HSC_MATURE_FETAL	HSC_MATURE_FETAL	P
GH_HYPOPHYSECTOMY_RAT_UP	GH_HYPOPHYSECTOMY_RAT_UP	P
HDACI_COLON_CUR24HRS_DN	HDACI_COLON_CUR24HRS_DN	P
TSADAC_PANC50_UP	TSADAC_PANC50_UP	P
O6BG_RESIST_MEDULLOBLASTOMA_DN	O6BG_RESIST_MEDULLOBLASTOMA_DN	P
EMT_UP	EMT_UP	P
DAC_PANC_UP	DAC_PANC_UP	P
ADIPOGENESIS_HMSC_CLASS2_UP	ADIPOGENESIS_HMSC_CLASS2_UP	P
4NQO_UNIQUE_FIBRO_DN	4NQO_UNIQUE_FIBRO_DN	P
UVC_TTD_ALL_UP	UVC_TTD_ALL_UP	P
STEMCELL_HEMATOPOIETIC_UP	STEMCELL_HEMATOPOIETIC_UP	P
ADIP_DIFF_CLUSTER2	ADIP_DIFF_CLUSTER2	P
ET743_SARCOMA_72HRS_DN	ET743_SARCOMA_72HRS_DN	P
HDACI_COLON_CLUSTER9	HDACI_COLON_CLUSTER9	P
LVAD_HEARTFAILURE_UP	LVAD_HEARTFAILURE_UP	P
OLDWERNER_FIBRO_UP	OLDWERNER_FIBRO_UP	P
BCNU_GLIOMA_MGMT_48HRS_UP	BCNU_GLIOMA_MGMT_48HRS_UP	P
ADIP_VS_PREADIP_UP	ADIP_VS_PREADIP_UP	P
UV_ESR_OLD_UNREG	UV_ESR_OLD_UNREG	P
UVC_LOW_C1_DN	UVC_LOW_C1_DN	P
CREB_BRAIN_2WKS_UP	CREB_BRAIN_2WKS_UP	P
HEARTFAILURE_VENTRICLE_DN	HEARTFAILURE_VENTRICLE_DN	P
HSC_MATURE_SHARED	HSC_MATURE_SHARED	P
BRCA_BRCA1_POS	BRCA_BRCA1_POS	P
ET743_SARCOMA_72HRS_UP	ET743_SARCOMA_72HRS_UP	P
ET743_SARCOMA_UP	ET743_SARCOMA_UP	P
HSC_LATEPROGENITORS_ADULT	HSC_LATEPROGENITORS_ADULT	P
UVC_HIGH_D3_DN	UVC_HIGH_D3_DN	P
P21_P53_LATE_DN	P21_P53_LATE_DN	P
MMS_HUMAN_LYMPH_HIGH_24HRS_UP	MMS_HUMAN_LYMPH_HIGH_24HRS_UP	P
HDACI_COLON_SUL24HRS_DN	HDACI_COLON_SUL24HRS_DN	P
TSA_HEPATOMA_UP	TSA_HEPATOMA_UP	P
CMV-CHX_HCMV_6HRS_DN	CMV-CHX_HCMV_6HRS_DN	P
VHL_RCC_UP	VHL_RCC_UP	P
BRCA_PROGNOSIS_NEG	BRCA_PROGNOSIS_NEG	P
ADIP_VS_FIBRO_UP	ADIP_VS_FIBRO_UP	P
AS3_FIBRO_C4	AS3_FIBRO_C4	P
HDACI_COLON_CUR12HRS_UP	HDACI_COLON_CUR12HRS_UP	P
GENOTOXINS_ALL_24HRS_REG	GENOTOXINS_ALL_24HRS_REG	P
TPA_RESIST_MIDDLE_UP	TPA_RESIST_MIDDLE_UP	P
P21_ANY_DN	P21_ANY_DN	P
WERNER_FIBRO_DN	WERNER_FIBRO_DN	P
MKK6EE_UP	MKK6EE_UP	P
CMV_ALL_UP	CMV_ALL_UP	P
VEGF_HUVEC_UP	VEGF_HUVEC_UP	P
UVB_NHEK1_C3	UVB_NHEK1_C3	P
HUMAN_TISSUE_SALIVARY	HUMAN_TISSUE_SALIVARY	P
MAMMARY_DEV_UP	MAMMARY_DEV_UP	P
CMV_HCMV_TIMECOURSE_10HRS_UP	CMV_HCMV_TIMECOURSE_10HRS_UP	P
5FU_RESIST_GASTRIC_DN	5FU_RESIST_GASTRIC_DN	P
NI2_MOUSE_DN	NI2_MOUSE_DN	P
STRESS_ARSENIC_SPECIFIC_UP	STRESS_ARSENIC_SPECIFIC_UP	P
LH_GRANULOSA_DN	LH_GRANULOSA_DN	P
TPA_SENS_EARLY_UP	TPA_SENS_EARLY_UP	P
INSULIN_ADIP_SENS_DN	INSULIN_ADIP_SENS_DN	P
UV_UNIQUE_FIBRO_DN	UV_UNIQUE_FIBRO_DN	P
UVC_LOW_C2_DN	UVC_LOW_C2_DN	P
CARIES_PULP_UP	CARIES_PULP_UP	P
GENOTOXINS_ALL_4HRS_REG	GENOTOXINS_ALL_4HRS_REG	P
ELONGINA_KO_DN	ELONGINA_KO_DN	P
BRG1_ALAB_UP	BRG1_ALAB_UP	P
PRMT5_KD_UP	PRMT5_KD_UP	P
HDACI_COLON_SUL2HRS_UP	HDACI_COLON_SUL2HRS_UP	P
PARP_KO_DN	PARP_KO_DN	P
DOX_RESIST_GASTRIC_UP	DOX_RESIST_GASTRIC_UP	P
IL1_CORNEA_UP	IL1_CORNEA_UP	P
DAC_FIBRO_DN	DAC_FIBRO_DN	P
RIBAVIRIN_RSV_UP	RIBAVIRIN_RSV_UP	P
HYPOXIA_NORMAL_UP	HYPOXIA_NORMAL_UP	P
HDACI_COLON_BUT48HRS_UP	HDACI_COLON_BUT48HRS_UP	P
BREASTCA_THREE_CLASSES	BREASTCA_THREE_CLASSES	P
EMT_DN	EMT_DN	P
AS3_FIBRO_C2	AS3_FIBRO_C2	P
STRESS_ARSENIC_SPECIFIC_DN	STRESS_ARSENIC_SPECIFIC_DN	P
TSADAC_HYPOMETH_HYPERAC_OVCA_UP	TSADAC_HYPOMETH_HYPERAC_OVCA_UP	P
CALRES_RHESUS_UP	CALRES_RHESUS_UP	P
HBX_HEP_DN	HBX_HEP_DN	P
UVC_TTD_8HR_UP	UVC_TTD_8HR_UP	P
REOVIRUS_HEK293_DN	REOVIRUS_HEK293_DN	P
TPA_RESIST_LATE_UP	TPA_RESIST_LATE_UP	P
REOVIRUS_HEK293_UP	REOVIRUS_HEK293_UP	P
CITED1_KO_WT_DN	CITED1_KO_WT_DN	P
CITED1_KO_WT_UP	CITED1_KO_WT_UP	P
UVB_NHEK3_C4	UVB_NHEK3_C4	P
TPA_SENS_MIDDLE_UP	TPA_SENS_MIDDLE_UP	P
GH_IGF_CHONDROCYTES_UP	GH_IGF_CHONDROCYTES_UP	P
BRACX_DN	BRACX_DN	P
UVC_TTD-XPCS_COMMON_UP	UVC_TTD-XPCS_COMMON_UP	P
UVC_HIGH_D6_DN	UVC_HIGH_D6_DN	P
CMV_HCMV_TIMECOURSE_20HRS_UP	CMV_HCMV_TIMECOURSE_20HRS_UP	P
COCAINE_BRAIN_5D_UP	COCAINE_BRAIN_5D_UP	P
INSULIN_ADIP_INSENS_DN	INSULIN_ADIP_INSENS_DN	P
HDACI_COLON_BUT48HRS_DN	HDACI_COLON_BUT48HRS_DN	P
INOS_ALL_DN	INOS_ALL_DN	P
OLD_FIBRO_UP	OLD_FIBRO_UP	P
FSH_GRANULOSA_UP	FSH_GRANULOSA_UP	P
LAL_KO_6MO_UP	LAL_KO_6MO_UP	P
HSC_MATURE_ADULT	HSC_MATURE_ADULT	P
ET743_RESIST_UP	ET743_RESIST_UP	P
MMS_HUMAN_LYMPH_LOW_4HRS_DN	MMS_HUMAN_LYMPH_LOW_4HRS_DN	P
AGED_RHESUS_DN	AGED_RHESUS_DN	P
WERNER_FIBRO_UP	WERNER_FIBRO_UP	P
PDGF_ES_UP	PDGF_ES_UP	P
CMV_24HRS_DN	CMV_24HRS_DN	P
TNFALPHA_4HRS_UP	TNFALPHA_4HRS_UP	P
HDACI_COLON_BUT12HRS_DN	HDACI_COLON_BUT12HRS_DN	P
DFOSB_BRAIN_8WKS_UP	DFOSB_BRAIN_8WKS_UP	P
GH_GHRHR_KO_6HRS_UP	GH_GHRHR_KO_6HRS_UP	P
5FU_RESIST_GASTRIC_UP	5FU_RESIST_GASTRIC_UP	P
TSA_HEPATOMA_CANCER_DN	TSA_HEPATOMA_CANCER_DN	P
CMV_HCMV_6HRS_UP	CMV_HCMV_6HRS_UP	P
IFNALPHA_RESIST_DN	IFNALPHA_RESIST_DN	P
SERUM_FIBROBLAST_CORE_DN	SERUM_FIBROBLAST_CORE_DN	P
TSA_RKO_UP	TSA_RKO_UP	P
H2O2_CSBDIFF_C2	H2O2_CSBDIFF_C2	P
ADIP_DIFF_CLUSTER1	ADIP_DIFF_CLUSTER1	P
HSC_INTERMEDIATEPROGENITORS_SHARED	HSC_INTERMEDIATEPROGENITORS_SHARED	P
HDACI_COLON_CLUSTER10	HDACI_COLON_CLUSTER10	P
STEMCELL_NEURAL_UP	STEMCELL_NEURAL_UP	P
OLDWERNER_FIBRO_DN	OLDWERNER_FIBRO_DN	P
HBX_NL_UP	HBX_NL_UP	P
IRS1_KO_ADIP_DN	IRS1_KO_ADIP_DN	P
P21_MIDDLE_DN	P21_MIDDLE_DN	P
BCRABL_HL60_AFFY_DN	BCRABL_HL60_AFFY_DN	P
4NQO_ESR_WS_UNREG	4NQO_ESR_WS_UNREG	P
WERNERONLY_FIBRO_UP	WERNERONLY_FIBRO_UP	P
CMV_HCMV_TIMECOURSE_20HRS_DN	CMV_HCMV_TIMECOURSE_20HRS_DN	P
HDACI_COLON_TSA2HRS_DN	HDACI_COLON_TSA2HRS_DN	P
DSRNA_UP	DSRNA_UP	P
BCNU_GLIOMA_NOMGMT_48HRS_UP	BCNU_GLIOMA_NOMGMT_48HRS_UP	P
H2O2_CSBDIFF_C1	H2O2_CSBDIFF_C1	P
NOVA2_KO_SPLICING	NOVA2_KO_SPLICING	P
UVB_NHEK1_C4	UVB_NHEK1_C4	P
GAMMA-UV_FIBRO_UP	GAMMA-UV_FIBRO_UP	P
DAC_PANC50_UP	DAC_PANC50_UP	P
DAC_CGI_BLADDER_UP	DAC_CGI_BLADDER_UP	P
UV-4NQO_FIBRO_DN	UV-4NQO_FIBRO_DN	P
GN_CAMP_GRANULOSA_UP	GN_CAMP_GRANULOSA_UP	P
RCC_NL_UP	RCC_NL_UP	P
UVB_NHEK1_C2	UVB_NHEK1_C2	P
METASTASIS_ADENOCARC_UP	METASTASIS_ADENOCARC_UP	P
VEGF_MMMEC_12HRS_UP	VEGF_MMMEC_12HRS_UP	P
STRESS_IONIZING_SPECIFIC_UP	STRESS_IONIZING_SPECIFIC_UP	P
DOX_RESIST_GASTRIC_DN	DOX_RESIST_GASTRIC_DN	P
ESR_FIBROBLAST_UP	ESR_FIBROBLAST_UP	P
CPR_LOW_LIVER_UP	CPR_LOW_LIVER_UP	P
BRCA_PROGNOSIS_POS	BRCA_PROGNOSIS_POS	P
HDACI_COLON_BUT30MIN_DN	HDACI_COLON_BUT30MIN_DN	P
UVB_SCC_UP	UVB_SCC_UP	P
BAF57_BT549_DN	BAF57_BT549_DN	P
IDX_TSA_DN_CLUSTER1	IDX_TSA_DN_CLUSTER1	P
BLEO_MOUSE_LYMPH_HIGH_24HRS_DN	BLEO_MOUSE_LYMPH_HIGH_24HRS_DN	P
AGED_MOUSE_NEOCORTEX_UP	AGED_MOUSE_NEOCORTEX_UP	P
HEATSHOCK_OLD_UP	HEATSHOCK_OLD_UP	P
VENTRICLES_UP	VENTRICLES_UP	P
CMV_HCMV_TIMECOURSE_1HR_DN	CMV_HCMV_TIMECOURSE_1HR_DN	P
HSC_HSCANDPROGENITORS_FETAL	HSC_HSCANDPROGENITORS_FETAL	P
AGED_MOUSE_MUSCLE_DN	AGED_MOUSE_MUSCLE_DN	P
IDX_TSA_DN_CLUSTER6	IDX_TSA_DN_CLUSTER6	P
HDACI_COLON_CLUSTER4	HDACI_COLON_CLUSTER4	P
UVC_LOW_ALL_DN	UVC_LOW_ALL_DN	P
UVC_HIGH_D1_DN	UVC_HIGH_D1_DN	P
UVB_NHEK3_C6	UVB_NHEK3_C6	P
ET743_SARCOMA_DN	ET743_SARCOMA_DN	P
UVB_NHEK3_C3	UVB_NHEK3_C3	P
OLDONLY_FIBRO_DN	OLDONLY_FIBRO_DN	P
GAMMA_ESR_WS_UNREG	GAMMA_ESR_WS_UNREG	P
UVC_XPCS_8HR_UP	UVC_XPCS_8HR_UP	P
UVB_NHEK3_C1	UVB_NHEK3_C1	P
TNFALPHA_ALL_UP	TNFALPHA_ALL_UP	P
IRS1_KO_ADIP_UP	IRS1_KO_ADIP_UP	P
HDACI_COLON_TSA12HRS_UP	HDACI_COLON_TSA12HRS_UP	P
IDX_TSA_UP_CLUSTER4	IDX_TSA_UP_CLUSTER4	P
SARCOMAS_SCHWANNOMA_UP	SARCOMAS_SCHWANNOMA_UP	P
3AB_GAMMA_DN	3AB_GAMMA_DN	P
AGEING_LYMPH_DN	AGEING_LYMPH_DN	P
DNMT1_KO_UP	DNMT1_KO_UP	P
HDACI_COLON_CLUSTER8	HDACI_COLON_CLUSTER8	P
NAB_LUNG_DN	NAB_LUNG_DN	P
CMV_HCMV_TIMECOURSE_18HRS_UP	CMV_HCMV_TIMECOURSE_18HRS_UP	P
POD1_KO_MOST_UP	POD1_KO_MOST_UP	P
VEGF_HUVEC_2HRS_UP	VEGF_HUVEC_2HRS_UP	P
HUMAN_TISSUE_TESTIS	HUMAN_TISSUE_TESTIS	P
RESISTANCE_XENOGRAFTS_UP	RESISTANCE_XENOGRAFTS_UP	P
REFRACTORY_GASTRIC_UP	REFRACTORY_GASTRIC_UP	P
HDACI_COLON_TSA_UP	HDACI_COLON_TSA_UP	P
HEARTFAILURE_ATRIA_UP	HEARTFAILURE_ATRIA_UP	P
HDACI_COLON_BUT2HRS_DN	HDACI_COLON_BUT2HRS_DN	P
FSH_OVARY_MCV152_UP	FSH_OVARY_MCV152_UP	P
CMV_HCMV_TIMECOURSE_8HRS_DN	CMV_HCMV_TIMECOURSE_8HRS_DN	P
HYPOXIA_REG_UP	HYPOXIA_REG_UP	P
BRACX_UP	BRACX_UP	P
BRCA1_OVEREXP_UP	BRCA1_OVEREXP_UP	P
TGZ_ADIP_UP	TGZ_ADIP_UP	P
CIS_RESIST_GASTRIC_UP	CIS_RESIST_GASTRIC_UP	P
H2O2_CSBRESCUED_C1_UP	H2O2_CSBRESCUED_C1_UP	P
UV_ESR_WS_UNREG	UV_ESR_WS_UNREG	P
UVC_XPCS_4HR_DN	UVC_XPCS_4HR_DN	P
IL6_SCAR_FIBRO_DN	IL6_SCAR_FIBRO_DN	P
GH_EXOGENOUS_LATE_UP	GH_EXOGENOUS_LATE_UP	P
JNK_UP	JNK_UP	P
IDX_TSA_UP_CLUSTER3	IDX_TSA_UP_CLUSTER3	P
HSC_LTHSC_SHARED	HSC_LTHSC_SHARED	P
TGFBETA_EARLY_UP	TGFBETA_EARLY_UP	P
ET743_HELA_UP	ET743_HELA_UP	P
TNFALPHA_ADIP_DN	TNFALPHA_ADIP_DN	P
HSC_LTHSC_FETAL	HSC_LTHSC_FETAL	P
ADIP_VS_PREADIP_DN	ADIP_VS_PREADIP_DN	P
TIS7_OVEREXP_DN	TIS7_OVEREXP_DN	P
AS3_HEK293_DN	AS3_HEK293_DN	P
CMV_ALL_DN	CMV_ALL_DN	P
ZMPSTE24_KO_DN	ZMPSTE24_KO_DN	P
TGFBETA_C2_UP	TGFBETA_C2_UP	P
ADIP_DIFF_CLUSTER5	ADIP_DIFF_CLUSTER5	P
RETT_DN	RETT_DN	P
HSC_EARLYPROGENITORS_ADULT	HSC_EARLYPROGENITORS_ADULT	P
ET743_SARCOMA_24HRS_UP	ET743_SARCOMA_24HRS_UP	P
UVB_NHEK2_DN	UVB_NHEK2_DN	P
IFN_GAMMA_UP	IFN_GAMMA_UP	P
HDACI_COLON_TSA_DN	HDACI_COLON_TSA_DN	P
TNFALPHA_ADIP_UP	TNFALPHA_ADIP_UP	P
IGF_VS_PDGF_DN	IGF_VS_PDGF_DN	P
HSC_STHSC_SHARED	HSC_STHSC_SHARED	P
SARCOMAS_HISTIOCYTOMA_UP	SARCOMAS_HISTIOCYTOMA_UP	P
IDX_TSA_DN_CLUSTER2	IDX_TSA_DN_CLUSTER2	P
STEMCELL_COMMON_UP	STEMCELL_COMMON_UP	P
TPA_SENS_LATE_DN	TPA_SENS_LATE_DN	P
BCRABL_HL60_CDNA_UP	BCRABL_HL60_CDNA_UP	P
NAB_LUNG_UP	NAB_LUNG_UP	P
LH_GRANULOSA_UP	LH_GRANULOSA_UP	P
POD1_KO_UP	POD1_KO_UP	P
CMV_HCMV_TIMECOURSE_16HRS_DN	CMV_HCMV_TIMECOURSE_16HRS_DN	P
CMV_8HRS_DN	CMV_8HRS_DN	P
BREASTCA_TWO_CLASSES	BREASTCA_TWO_CLASSES	P
HYPOXIA_RCC_UP	HYPOXIA_RCC_UP	P
BCNU_GLIOMA_MGMT_48HRS_DN	BCNU_GLIOMA_MGMT_48HRS_DN	P
TSADAC_HYPERMETH_HYPERAC_OVCA_UP	TSADAC_HYPERMETH_HYPERAC_OVCA_UP	P
CMV_HCMV_TIMECOURSE_ALL_UP	CMV_HCMV_TIMECOURSE_ALL_UP	P
HDACI_COLON_CUR_UP	HDACI_COLON_CUR_UP	P
UVC_HIGH_D5_DN	UVC_HIGH_D5_DN	P
HEARTFAILURE_ATRIA_DN	HEARTFAILURE_ATRIA_DN	P
HPV31_UP	HPV31_UP	P
HUMAN_TISSUE_KIDNEY	HUMAN_TISSUE_KIDNEY	P
HSC_LTHSC_ADULT	HSC_LTHSC_ADULT	P
TNFALPHA_30MIN_UP	TNFALPHA_30MIN_UP	P
MIDDLEAGE_DN	MIDDLEAGE_DN	P
BRCA2_BRCA1_UP	BRCA2_BRCA1_UP	P
UVB_NHEK2_UP	UVB_NHEK2_UP	P
CALRES_MOUSE_UP	CALRES_MOUSE_UP	P
SERUM_FIBROBLAST_CELLCYCLE	SERUM_FIBROBLAST_CELLCYCLE	P
CMV_HCMV_TIMECOURSE_24HRS_DN	CMV_HCMV_TIMECOURSE_24HRS_DN	P
TGFBETA_LATE_UP	TGFBETA_LATE_UP	P
HDACI_COLON_BUT16HRS_UP	HDACI_COLON_BUT16HRS_UP	P
H2O2_CSBRESCUED_UP	H2O2_CSBRESCUED_UP	P
HDACI_COLON_TSABUT_UP	HDACI_COLON_TSABUT_UP	P
TGFBETA_C3_UP	TGFBETA_C3_UP	P
4NQO_UNIQUE_FIBRO_UP	4NQO_UNIQUE_FIBRO_UP	P
HDACI_COLON_SUL16HRS_DN	HDACI_COLON_SUL16HRS_DN	P
4NQO_ESR_OLD_UNREG	4NQO_ESR_OLD_UNREG	P
H2O2_CSBCOMBINED	H2O2_CSBCOMBINED	P
HUMAN_TISSUE_THYMUS	HUMAN_TISSUE_THYMUS	P
ALZHEIMERS_INCIPIENT_UP	ALZHEIMERS_INCIPIENT_UP	P
BCNU_GLIOMA_NOMGMT_24HRS_UP	BCNU_GLIOMA_NOMGMT_24HRS_UP	P
BRCA1_SW480_DN	BRCA1_SW480_DN	P
IDX_TSA_UP_CLUSTER2	IDX_TSA_UP_CLUSTER2	P
PRMT5_KD_DN	PRMT5_KD_DN	P
CANCERDRUGS_PROBCELL_UP	CANCERDRUGS_PROBCELL_UP	P
CMV_HCMV_TIMECOURSE_16HRS_UP	CMV_HCMV_TIMECOURSE_16HRS_UP	P
GH_EXOGENOUS_ANY_UP	GH_EXOGENOUS_ANY_UP	P
CMV_HCMV_TIMECOURSE_14HRS_DN	CMV_HCMV_TIMECOURSE_14HRS_DN	P
AD12_32HRS_DN	AD12_32HRS_DN	P
ADIP_DIFF_UP	ADIP_DIFF_UP	P
RIBAVIRIN_RSV_DN	RIBAVIRIN_RSV_DN	P
HDACI_COLON_TSA24HRS_DN	HDACI_COLON_TSA24HRS_DN	P
ET743_RESIST_DN	ET743_RESIST_DN	P
TGFBETA_ALL_UP	TGFBETA_ALL_UP	P
IFNA_UV-CMV_COMMON_HCMV_6HRS_UP	IFNA_UV-CMV_COMMON_HCMV_6HRS_UP	P
INSULIN_ADIP_INSENS_UP	INSULIN_ADIP_INSENS_UP	P
UVB_NHEK4_6HRS_UP	UVB_NHEK4_6HRS_UP	P
GH_EXOGENOUS_LATE_DN	GH_EXOGENOUS_LATE_DN	P
HDACI_COLON_SUL_DN	HDACI_COLON_SUL_DN	P
AGED_MOUSE_NEOCORTEX_DN	AGED_MOUSE_NEOCORTEX_DN	P
AD12_24HRS_DN	AD12_24HRS_DN	P
DFOSB_BRAIN_2WKS_UP	DFOSB_BRAIN_2WKS_UP	P
MIDDLEAGE_UP	MIDDLEAGE_UP	P
IRS_KO_ADIP_UP	IRS_KO_ADIP_UP	P
BRG1_H1299_UP	BRG1_H1299_UP	P
CMV_HCMV_6HRS_DN	CMV_HCMV_6HRS_DN	P
HIF1_TARGETS	HIF1_TARGETS	P
P21_P53_MIDDLE_DN	P21_P53_MIDDLE_DN	P
CARIES_PULP_DN	CARIES_PULP_DN	P
BLEO_MOUSE_LYMPH_LOW_24HRS_DN	BLEO_MOUSE_LYMPH_LOW_24HRS_DN	P
FSH_OVARY_MCV152_DN	FSH_OVARY_MCV152_DN	P
IFNALPHA_HCC_UP	IFNALPHA_HCC_UP	P
AGED_MOUSE_CEREBELLUM_DN	AGED_MOUSE_CEREBELLUM_DN	P
P53_BRCA1_UP	P53_BRCA1_UP	P
HDACI_COLON_SUL48HRS_DN	HDACI_COLON_SUL48HRS_DN	P
HEMATOP_STEM_ALL_UP	HEMATOP_STEM_ALL_UP	P
UVC_HIGH_ALL_UP	UVC_HIGH_ALL_UP	P
AGED_MOUSE_HYPOTH_DN	AGED_MOUSE_HYPOTH_DN	P
HUMAN_TISSUE_LIVER	HUMAN_TISSUE_LIVER	P
HDACI_COLON_CUR16HRS_DN	HDACI_COLON_CUR16HRS_DN	P
ET743_SARCOMA_6HRS_UP	ET743_SARCOMA_6HRS_UP	P
FSH_GRANULOSA_DN	FSH_GRANULOSA_DN	P
HDACI_COLON_TSA30MIN_DN	HDACI_COLON_TSA30MIN_DN	P
CMV_UV-CMV_COMMON_HCMV_6HRS_DN	CMV_UV-CMV_COMMON_HCMV_6HRS_DN	P
ADIPOGENESIS_HMSC_CLASS1_UP	ADIPOGENESIS_HMSC_CLASS1_UP	P
NF90_DN	NF90_DN	P
POD1_KO_DN	POD1_KO_DN	P
IFN_BETA_UP	IFN_BETA_UP	P
CAMPTOTHECIN_PROBCELL_DN	CAMPTOTHECIN_PROBCELL_DN	P
HDACI_COLON_SUL24HRS_UP	HDACI_COLON_SUL24HRS_UP	P
IFN_ALPHA_UP	IFN_ALPHA_UP	P
P21_EARLY_DN	P21_EARLY_DN	P
HDACI_COLON_CUR24HRS_UP	HDACI_COLON_CUR24HRS_UP	P
VEGF_MMMEC_6HRS_UP	VEGF_MMMEC_6HRS_UP	P
O6BG_RESIST_MEDULLOBLASTOMA_UP	O6BG_RESIST_MEDULLOBLASTOMA_UP	P
BRG1_SW13_UP	BRG1_SW13_UP	P
HSC_STHSC_ADULT	HSC_STHSC_ADULT	P
OXSTRESS_RPE_H2O2TBH_DN	OXSTRESS_RPE_H2O2TBH_DN	P
LAL_KO_3MO_UP	LAL_KO_3MO_UP	P
ADIP_DIFF_CLUSTER3	ADIP_DIFF_CLUSTER3	P
AGED_MOUSE_HIPPOCAMPUS_ANY_DN	AGED_MOUSE_HIPPOCAMPUS_ANY_DN	P
IL1_CORNEA_DN	IL1_CORNEA_DN	P
BRCA_BRCA1_NEG	BRCA_BRCA1_NEG	P
CISPLATIN_PROBCELL_UP	CISPLATIN_PROBCELL_UP	P
HDACI_COLON_SUL12HRS_UP	HDACI_COLON_SUL12HRS_UP	P
GAMMA_ESR_OLD_UNREG	GAMMA_ESR_OLD_UNREG	P
OXSTRESS_RPE_H2O2HNE_DN	OXSTRESS_RPE_H2O2HNE_DN	P
AGED_MOUSE_CORTEX_DN	AGED_MOUSE_CORTEX_DN	P
PITUITARY_FETAL_UP	PITUITARY_FETAL_UP	P
ADIP_VS_FIBRO_DN	ADIP_VS_FIBRO_DN	P
CANTHARIDIN_DN	CANTHARIDIN_DN	P
HSC_INTERMEDIATEPROGENITORS_ADULT	HSC_INTERMEDIATEPROGENITORS_ADULT	P
UVC_LOW_A2_UP	UVC_LOW_A2_UP	P
RETT_UP	RETT_UP	P
TFF2_KO_UP	TFF2_KO_UP	P
HSC_HSC_ADULT	HSC_HSC_ADULT	P
ERM_KO_SERTOLI_DN	ERM_KO_SERTOLI_DN	P
CALRES_MOUSE_NEOCORTEX_DN	CALRES_MOUSE_NEOCORTEX_DN	P
H2O2_CSBRESCUED_C2_UP	H2O2_CSBRESCUED_C2_UP	P
CMV_UV-CMV_COMMON_HCMV_6HRS_UP	CMV_UV-CMV_COMMON_HCMV_6HRS_UP	P
CMV_HCMV_TIMECOURSE_6HRS_DN	CMV_HCMV_TIMECOURSE_6HRS_DN	P
GH_GHRHR_KO_24HRS_UP	GH_GHRHR_KO_24HRS_UP	P
MMS_MOUSE_LYMPH_HIGH_4HRS_UP	MMS_MOUSE_LYMPH_HIGH_4HRS_UP	P
HSC_HSC_FETAL	HSC_HSC_FETAL	P
VHL_NORMAL_UP	VHL_NORMAL_UP	P
UVC_HIGH_D4_DN	UVC_HIGH_D4_DN	P
OXSTRESS_BREASTCA_UP	OXSTRESS_BREASTCA_UP	P
IFN_ANY_UP	IFN_ANY_UP	P
ZMPSTE24_KO_UP	ZMPSTE24_KO_UP	P
BRG1_ALAB_DN	BRG1_ALAB_DN	P
HDACI_COLON_CURSUL_UP	HDACI_COLON_CURSUL_UP	P
