ABC_gt_GCB_Affy	ABC_gt_GCB_Affy	P
ABC_gt_GCB_LC	ABC_gt_GCB_LC	P
Adrenal_cortex_Node4284	Adrenal_cortex_Node4284	P
BCL6_repressed	BCL6_repressed	P
BCL6_targets_CHIPCHIP	BCL6_targets_CHIPCHIP	P
B_cell_Node1500	B_cell_Node1500	P
B_cell_down_anergy	B_cell_down_anergy	P
B_cell_up_anergy	B_cell_up_anergy	P
Blimp_Bcell_repressed	Blimp_Bcell_repressed	P
Blimp_proliferation_repressed	Blimp_proliferation_repressed	P
Blood_CD4+Tcell_gt_thymic_SP_CD4+Tcell	Blood_CD4+Tcell_gt_thymic_SP_CD4+Tcell	P
BreastCa_70gene_Bad	BreastCa_70gene_Bad	P
BreastCa_70gene_Good	BreastCa_70gene_Good	P
BreastCa_Bone_Metastasis	BreastCa_Bone_Metastasis	P
CD40_downregulated_Burkitt_lymphoma	CD40_downregulated_Burkitt_lymphoma	P
CD40_upregulated_Burkitt_lymphoma	CD40_upregulated_Burkitt_lymphoma	P
CD4_T_U133plus	CD4_T_U133plus	P
CD8_T_U133plus	CD8_T_U133plus	P
CD8_T_effectorDn_memoryDn_NaiveUp	CD8_T_effectorDn_memoryDn_NaiveUp	P
CD8_T_effectorDn_memoryIm_NaiveUp	CD8_T_effectorDn_memoryIm_NaiveUp	P
CD8_T_effectorDn_memoryUp_NaiveUp	CD8_T_effectorDn_memoryUp_NaiveUp	P
CD8_T_effectorUp_memoryIm_NaiveDn	CD8_T_effectorUp_memoryIm_NaiveDn	P
CD8_T_effectorUp_memoryUp_NaiveDn	CD8_T_effectorUp_memoryUp_NaiveDn	P
CLL_mutated_gt_CLL_unmutated	CLL_mutated_gt_CLL_unmutated	P
CLL_unmutated_gt_CLL_mutated	CLL_unmutated_gt_CLL_mutated	P
CNS_Node1661	CNS_Node1661	P
CNS_PNS_Node1663	CNS_PNS_Node1663	P
CNSonly_Node1460	CNSonly_Node1460	P
Cell_cycle_Cho	Cell_cycle_Cho	P
Cell_cycle_Cho&Whitfield	Cell_cycle_Cho&Whitfield	P
Cell_cycle_Liu	Cell_cycle_Liu	P
Cell_cycle_Whitfield	Cell_cycle_Whitfield	P
DC_TLR4_TLR8_synergy	DC_TLR4_TLR8_synergy	P
Dendritic_cell_BDCA1pos_blood	Dendritic_cell_BDCA1pos_blood	P
Dendritic_cell_BDCA1pos_tonsil	Dendritic_cell_BDCA1pos_tonsil	P
Dendritic_cell_BDCA3pos_blood	Dendritic_cell_BDCA3pos_blood	P
Dendritic_cell_CD123pos_blood	Dendritic_cell_CD123pos_blood	P
Dendritic_cell_CD123pos_tonsil	Dendritic_cell_CD123pos_tonsil	P
Dendritic_cell_CD16pos_blood	Dendritic_cell_CD16pos_blood	P
E2F3_overexpression_2x_up	E2F3_overexpression_2x_up	P
E2F3_overexpression_4x_up	E2F3_overexpression_4x_up	P
Endothelial_precursor_GNF	Endothelial_precursor_GNF	P
Epithelial_keritin_Node1641	Epithelial_keritin_Node1641	P
Epithelium_Node1413	Epithelium_Node1413	P
Epithelium_Node5693	Epithelium_Node5693	P
Erythrocytic_Node1660	Erythrocytic_Node1660	P
Erythroid_precursor_GNF	Erythroid_precursor_GNF	P
Follicular_dendritic_cell	Follicular_dendritic_cell	P
Follicular_lymphoma_Immune_Response1	Follicular_lymphoma_Immune_Response1	P
Follicular_lymphoma_Immune_Response2	Follicular_lymphoma_Immune_Response2	P
G2_M_phase	G2_M_phase	P
GCB_gt_ABC_Affy	GCB_gt_ABC_Affy	P
GCB_gt_ABC_LC	GCB_gt_ABC_LC	P
GC_B_DLBCL_survival	GC_B_DLBCL_survival	P
GC_B_cell_BL_equal_DLBCL	GC_B_cell_BL_equal_DLBCL	P
GC_B_cell_BLhigh_DLBCLlow	GC_B_cell_BLhigh_DLBCLlow	P
GC_B_cell_BLlow_DLBCLhigh	GC_B_cell_BLlow_DLBCLhigh	P
GC_B_cell_U133Plus	GC_B_cell_U133Plus	P
GC_T_helper_down_Kim	GC_T_helper_down_Kim	P
GC_T_helper_up2x_Chtanova	GC_T_helper_up2x_Chtanova	P
GC_T_helper_up4x_Chtanova	GC_T_helper_up4x_Chtanova	P
GC_T_helper_up_Chtanova_and_Kim	GC_T_helper_up_Chtanova_and_Kim	P
GC_T_helper_up_Kim	GC_T_helper_up_Kim	P
Germinal_center_Bcell_DLBCL	Germinal_center_Bcell_DLBCL	P
Glucose_starve_down	Glucose_starve_down	P
Glucose_starve_up	Glucose_starve_up	P
Glutamine_Glucose_starve_both_down	Glutamine_Glucose_starve_both_down	P
Glutamine_Glucose_starve_both_up	Glutamine_Glucose_starve_both_up	P
Glutamine_starve_down	Glutamine_starve_down	P
Glutamine_starve_up	Glutamine_starve_up	P
Glycolysis	Glycolysis	P
HIF1alpha_1.5x_Up	HIF1alpha_1.5x_Up	P
HIF1alpha_1.5x_down	HIF1alpha_1.5x_down	P
HIF1alpha_2x_Up	HIF1alpha_2x_Up	P
HIF1alpha_2x_down	HIF1alpha_2x_down	P
HRAS_overexpression_2x_down	HRAS_overexpression_2x_down	P
HRAS_overexpression_2x_up	HRAS_overexpression_2x_up	P
HRAS_overexpression_4x_up	HRAS_overexpression_4x_up	P
Hemaglobin_Node98	Hemaglobin_Node98	P
Hematopoietic_Node1658	Hematopoietic_Node1658	P
Hematopoietic_Node1659	Hematopoietic_Node1659	P
IFN_PMBC_2x_Up	IFN_PMBC_2x_Up	P
IFN_PMBC_4x_Up	IFN_PMBC_4x_Up	P
IL10_OCILy3_Up	IL10_OCILy3_Up	P
IL6_Ly10_Up_all	IL6_Ly10_Up_all	P
IL6_Ly10_Up_group1	IL6_Ly10_Up_group1	P
IL6_Ly10_Up_group2	IL6_Ly10_Up_group2	P
IL6_Ly10_Up_group3	IL6_Ly10_Up_group3	P
IRF3_target_gene	IRF3_target_gene	P
IRF4_myeloma_induced_Agilent	IRF4_myeloma_induced_Agilent	P
IRF4_myeloma_induced_Lymphochip	IRF4_myeloma_induced_Lymphochip	P
IRF4_myeloma_induced_all	IRF4_myeloma_induced_all	P
IRF4_myeloma_induced_direct	IRF4_myeloma_induced_direct	P
Immediate_early	Immediate_early	P
Immunoglobulin_Node2868	Immunoglobulin_Node2868	P
JAK_IL10_Ly10_Up	JAK_IL10_Ly10_Up	P
KLF2_induced	KLF2_induced	P
KLF2_repressed	KLF2_repressed	P
KRAS_Down	KRAS_Down	P
KRAS_Up	KRAS_Up	P
Leucine_starve_down	Leucine_starve_down	P
Leucine_starve_up	Leucine_starve_up	P
Lipid_enzyme_Node3152	Lipid_enzyme_Node3152	P
Liver_fetal_lung_Node1634	Liver_fetal_lung_Node1634	P
Lung_Node3969	Lung_Node3969	P
Lymph_node_DLBCL	Lymph_node_DLBCL	P
Lymph_node_DLBCL_survival	Lymph_node_DLBCL_survival	P
MCL_gt_SLL_DLBCL	MCL_gt_SLL_DLBCL	P
MCL_proliferation_survival	MCL_proliferation_survival	P
MHC_classII_DLBCL	MHC_classII_DLBCL	P
MHC_classII_DLBCL_survival	MHC_classII_DLBCL_survival	P
MHC_classII_Node528	MHC_classII_Node528	P
MHC_classI_Node591	MHC_classI_Node591	P
Metallothionein_Node595	Metallothionein_Node595	P
Monocyte_4x_U133plus	Monocyte_4x_U133plus	P
Monocyte_8x_U133plus	Monocyte_8x_U133plus	P
Muscle_Node1645	Muscle_Node1645	P
Muscle_Node2235	Muscle_Node2235	P
Myc_ChIP_PET_2plus	Myc_ChIP_PET_2plus	P
Myc_ChIP_PET_3plus	Myc_ChIP_PET_3plus	P
Myc_ChIP_PET_Expr_Down	Myc_ChIP_PET_Expr_Down	P
Myc_ChIP_PET_Expr_Up	Myc_ChIP_PET_Expr_Up	P
Myc_RNAi_OCILy3	Myc_RNAi_OCILy3	P
Myc_overexpression_1.5x_up	Myc_overexpression_1.5x_up	P
Myc_overexpression_2x_down	Myc_overexpression_2x_down	P
Myc_overexpression_2x_up	Myc_overexpression_2x_up	P
Myeloid_Node1536	Myeloid_Node1536	P
Myeloid_Node2894	Myeloid_Node2894	P
Myeloid_progenitor_Node3051	Myeloid_progenitor_Node3051	P
Myeloma_CD-1_subgroup_down	Myeloma_CD-1_subgroup_down	P
Myeloma_CD-1_subgroup_up	Myeloma_CD-1_subgroup_up	P
Myeloma_CD-2_subgroup_down	Myeloma_CD-2_subgroup_down	P
Myeloma_CD-2_subgroup_up	Myeloma_CD-2_subgroup_up	P
Myeloma_HY_subgroup_down	Myeloma_HY_subgroup_down	P
Myeloma_HY_subgroup_up	Myeloma_HY_subgroup_up	P
Myeloma_LB_subgroup_down	Myeloma_LB_subgroup_down	P
Myeloma_LB_subgroup_up	Myeloma_LB_subgroup_up	P
Myeloma_MF_subgroup_down	Myeloma_MF_subgroup_down	P
Myeloma_MF_subgroup_up	Myeloma_MF_subgroup_up	P
Myeloma_MS_subgroup_down	Myeloma_MS_subgroup_down	P
Myeloma_MS_subgroup_up	Myeloma_MS_subgroup_up	P
Myeloma_PR_subgroup_down	Myeloma_PR_subgroup_down	P
Myeloma_PR_subgroup_up	Myeloma_PR_subgroup_up	P
Myeloma_TACI_high_bone_marrow_plasma_cell_gene	Myeloma_TACI_high_bone_marrow_plasma_cell_gene	P
Myeloma_TACI_low_plasmablast_gene	Myeloma_TACI_low_plasmablast_gene	P
NFKB_K1106	NFKB_K1106	P
NFkB_OCILy10_only	NFkB_OCILy10_only	P
NFkB_OCILy3_only	NFkB_OCILy3_only	P
NFkB_all_OCILy3_Ly10	NFkB_all_OCILy3_Ly10	P
NFkB_bothOCILy3andLy10	NFkB_bothOCILy3andLy10	P
NK_U133plus	NK_U133plus	P
Normal_mesenchymal-1_Node1643	Normal_mesenchymal-1_Node1643	P
Normal_mesenchymal-2_Node1615	Normal_mesenchymal-2_Node1615	P
Notch_T-ALL_down_Palomero	Notch_T-ALL_down_Palomero	P
Notch_T-ALL_down_Sharma	Notch_T-ALL_down_Sharma	P
Notch_T-ALL_down_Weng	Notch_T-ALL_down_Weng	P
Notch_T-ALL_up_Palomero	Notch_T-ALL_up_Palomero	P
Notch_T-ALL_up_Sharma	Notch_T-ALL_up_Sharma	P
Notch_T-ALL_up_Weng	Notch_T-ALL_up_Weng	P
Notch_T-ALL_up_concensus	Notch_T-ALL_up_concensus	P
OCAB_up	OCAB_up	P
PAX5_repressed	PAX5_repressed	P
PGC-1alpha_overepxression_up	PGC-1alpha_overepxression_up	P
PMBL_HL_high	PMBL_HL_high	P
PMBLhigh_HLlow	PMBLhigh_HLlow	P
Pan_B_U133plus	Pan_B_U133plus	P
Pancreas_Node1629	Pancreas_Node1629	P
Pituitary_lung_Node1582	Pituitary_lung_Node1582	P
Placenta_Node1337	Placenta_Node1337	P
Plasma_cell_gt_mature_Bcell	Plasma_cell_gt_mature_Bcell	P
Proliferation_DLBCL	Proliferation_DLBCL	P
Proliferation_DLBCL_survival	Proliferation_DLBCL_survival	P
Proliferation_Node1542	Proliferation_Node1542	P
Proliferation_Node1606	Proliferation_Node1606	P
Proliferation_Node1618	Proliferation_Node1618	P
Proliferation_Node1640	Proliferation_Node1640	P
Quiescence_heme_all	Quiescence_heme_all	P
Quiescence_heme_cluster1	Quiescence_heme_cluster1	P
Quiescence_heme_cluster2	Quiescence_heme_cluster2	P
Quiescence_heme_cluster3	Quiescence_heme_cluster3	P
Regulatory_T_cell_McHugh_Herman_concensus	Regulatory_T_cell_McHugh_Herman_concensus	P
Regulatory_Tcell_FOXP3+_3x_gt_CD4+Tcell	Regulatory_Tcell_FOXP3+_3x_gt_CD4+Tcell	P
Regulatory_Tcell_FOXP3+_4x_gt_CD4+Tcell	Regulatory_Tcell_FOXP3+_4x_gt_CD4+Tcell	P
Resting_blood_B_cell_GNF	Resting_blood_B_cell_GNF	P
Resting_blood_NK_cell_GNF	Resting_blood_NK_cell_GNF	P
Resting_dendritic_cell_GNF	Resting_dendritic_cell_GNF	P
Resting_monocyte_GNF	Resting_monocyte_GNF	P
Resting_panT_cell_CD4+CD8+_GNF	Resting_panT_cell_CD4+CD8+_GNF	P
Reticulocyte_large	Reticulocyte_large	P
Reticulocyte_small	Reticulocyte_small	P
Ribosomal_protein	Ribosomal_protein	P
SREBP1a&2_up_Scap_dep	SREBP1a&2_up_Scap_dep	P
SREBP1a&2_up_Scap_indep	SREBP1a&2_up_Scap_indep	P
SREBP1a_up	SREBP1a_up	P
SREBP2_up	SREBP2_up	P
STAT3_up_OCILy10	STAT3_up_OCILy10	P
STAT3high_ABC_DLBCL_subgroup	STAT3high_ABC_DLBCL_subgroup	P
STAT3low_ABC_DLBCL_subgroup	STAT3low_ABC_DLBCL_subgroup	P
Salivary_secretory_gland_Node1603	Salivary_secretory_gland_Node1603	P
Serum_response_Fb_down	Serum_response_Fb_down	P
Serum_response_Fb_up	Serum_response_Fb_up	P
Splenic_Marginal_zone_Bcell_gt_naive_and_GC_Bcell	Splenic_Marginal_zone_Bcell_gt_naive_and_GC_Bcell	P
Splenic_marginal_zone_Bcell_gt_GC_Bcell	Splenic_marginal_zone_Bcell_gt_GC_Bcell	P
TGFbeta_down_epithelial_large	TGFbeta_down_epithelial_large	P
TGFbeta_down_epithelial_small	TGFbeta_down_epithelial_small	P
TGFbeta_up_epithelial_large	TGFbeta_up_epithelial_large	P
TGFbeta_up_epithelial_small	TGFbeta_up_epithelial_small	P
T_NK_Node1604	T_NK_Node1604	P
T_NK_Node5808	T_NK_Node5808	P
T_cell	T_cell	P
T_cell_up_ionomycin_anergy	T_cell_up_ionomycin_anergy	P
Tcell_PIind4x_CsAindependent	Tcell_PIind4x_CsAindependent	P
Tcell_PIind4x_Feske_Fig4	Tcell_PIind4x_Feske_Fig4	P
Tcell_PIind4x_Feske_Fig6	Tcell_PIind4x_Feske_Fig6	P
Tcell_PIind_CalciumDefPtdown4x_Feske_Fig4	Tcell_PIind_CalciumDefPtdown4x_Feske_Fig4	P
Tcell_PIind_CalciumDefPtdown4x_Feske_Fig6	Tcell_PIind_CalciumDefPtdown4x_Feske_Fig6	P
Tcell_PIind_CsAdown4x	Tcell_PIind_CsAdown4x	P
Tcell_PIrep4x_CsAindependent	Tcell_PIrep4x_CsAindependent	P
Tcell_PIrep4x_Feske_Fig4	Tcell_PIrep4x_Feske_Fig4	P
Tcell_PIrep4x_Feske_Fig6	Tcell_PIrep4x_Feske_Fig6	P
Tcell_PIrep_CalciumDefPtup4x_Feske_Fig4	Tcell_PIrep_CalciumDefPtup4x_Feske_Fig4	P
Tcell_PIrep_CalciumDefPtup4x_Feske_Fig6	Tcell_PIrep_CalciumDefPtup4x_Feske_Fig6	P
Tcell_PIrep_CsAup4x	Tcell_PIrep_CsAup4x	P
Tcell_cytokine_induced_Bcell_induced	Tcell_cytokine_induced_Bcell_induced	P
Tcell_cytokine_induced_IL2_IL7_IL15_IL4	Tcell_cytokine_induced_IL2_IL7_IL15_IL4	P
Tcell_cytokine_induced_IL2_IL7_IL15only	Tcell_cytokine_induced_IL2_IL7_IL15only	P
Tcell_cytokine_induced_IL4only	Tcell_cytokine_induced_IL4only	P
Tcell_cytokine_induced_PBMC_Bcell_nochange	Tcell_cytokine_induced_PBMC_Bcell_nochange	P
Tcell_cytokine_induced_PMBC_Bcell_induced	Tcell_cytokine_induced_PMBC_Bcell_induced	P
Tcell_cytokine_induced_PMBConly_Iinduced	Tcell_cytokine_induced_PMBConly_Iinduced	P
Tcell_cytokine_induced_prolif	Tcell_cytokine_induced_prolif	P
Tcell_cytokine_repressed	Tcell_cytokine_repressed	P
Testis_Node1662	Testis_Node1662	P
Thymic_DP_Tcell_gt_Thymic_SP_CD4+Tcell	Thymic_DP_Tcell_gt_Thymic_SP_CD4+Tcell	P
Thymic_DP_Tcell_gt_Thymic_progenitor_Tcell	Thymic_DP_Tcell_gt_Thymic_progenitor_Tcell	P
Thymic_SP_CD4+Tcell_gt_Blood_CD4+Tcell	Thymic_SP_CD4+Tcell_gt_Blood_CD4+Tcell	P
Thymic_SP_CD4+Tcell_gt_Thymic_DP_Tcell	Thymic_SP_CD4+Tcell_gt_Thymic_DP_Tcell	P
Thymic_progenitor_Tcell_gt_Thymic_DP_Tcell	Thymic_progenitor_Tcell_gt_Thymic_DP_Tcell	P
XBP1_target_all	XBP1_target_all	P
XBP1_target_other	XBP1_target_other	P
XBP1_target_secretory	XBP1_target_secretory	P
p53_up_Xray	p53_up_Xray	P
