ABCA1	h_nuclearRsPathway
ABCB11	h_mrpPathway	h_nuclearRsPathway
ABCB1	h_mrpPathway	h_nuclearRsPathway	h_p53hypoxiaPathway
ABCB4	h_mrpPathway	h_nuclearRsPathway
ABCC1	h_mrpPathway
ABCC2	h_nuclearRsPathway
ABCC3	h_mrpPathway	h_nuclearRsPathway
ABCD2	h_nuclearRsPathway
ABCD3	h_nuclearRsPathway
ABCG1	h_nuclearRsPathway
ABCG5	h_nuclearRsPathway
ABI2	h_actinYPathway
ABL1	h_Lis1Pathway	h_arfPathway	h_atmPathway	h_g1Pathway
ACACA	h_leptinPathway
ACAT1	h_LDLpathway
ACE2	h_ace2Pathway
ACE	h_ace2Pathway
ACLY	h_malatexPathway
ACOX1	h_pparaPathway
ACSBG1	h_chrebpPathway
ACSS2	h_cptPathway
ACTA1	h_PDZsPathway	h_actinYPathway	h_agrPathway	h_ephA4Pathway	h_hsp27Pathway	h_integrinPathway	h_mCalpainPathway	h_mPRPathway	h_malPathway	h_metPathway	h_nfatPathway	h_no1Pathway	h_rabPathway	h_salmonellaPathway	h_ucalpainPathway
ACTB	h_hSWI-SNFpathway
ACTG1	h_HivnefPathway
ACTL6A	h_vdrPathway
ACTN2	h_cell2cellPathway	h_integrinPathway	h_ucalpainPathway
ACVR1	h_alkPathway
ADAM10	h_appPathway
ADAM12	h_cardiacegfPathway
ADAM17	h_erbB4pathway	h_notchpathway	h_ps1Pathway
ADAR	h_antisensePathway
ADCY1	h_CSKPathway	h_Par1Pathway	h_bArrestin-srcPathway	h_bArrestinPathway	h_badPathway	h_barr-mapkPathway	h_cftrPathway	h_chrebpPathway	h_crebPathway	h_cremPathway	h_edg1Pathway	h_gpcrPathway	h_gsPathway	h_igf1rPathway	h_mPRPathway	h_plcePathway	h_raccPathway
ADD1	h_PDZsPathway
ADIPOQ	h_vobesityPathway
ADRA1B	h_plcdPathway
ADRB2	h_cftrPathway	h_gcrPathway	h_plcePathway
ADRBK1	h_bArrestin-srcPathway	h_bArrestinPathway	h_barr-mapkPathway
AGRN	h_agrPathway
AGT	h_At1rPathway	h_ace2Pathway	h_biopeptidesPathway	h_cardiacegfPathway	h_nfatPathway
AGTR1	h_At1rPathway	h_ace2Pathway
AGTR2	h_ace2Pathway	h_biopeptidesPathway	h_cardiacegfPathway
AHR	h_acrPathway
AICDA	h_actinYPathway	h_cdc42racPathway	h_mPRPathway	h_rhoPathway	h_salmonellaPathway
AIFM1	h_aifPathway	h_ceramidePathway	h_mitochondriaPathway
AIP	h_acrPathway
AKAP13	h_akap13Pathway
AKAP8	h_akap95Pathway
AKAP9	h_akapCentrosomePathway
AKR7A2	h_arenrf2Pathway
AKT1	h_RacCycDPathway	h_achPathway	h_aktPathway	h_badPathway	h_bcellsurvivalPathway	h_chemicalPathway	h_crebPathway	h_edg1Pathway	h_eif4Pathway	h_erk5Pathway	h_gcrPathway	h_gleevecpathway	h_gsk3Pathway	h_hcmvPathway	h_hdacPathway	h_igf1mtorpathway	h_igf1rPathway	h_il2rbPathway	h_il4Pathway	h_longevityPathway	h_mTORPathway	h_nfatPathway	h_no1Pathway	h_p53hypoxiaPathway	h_plcPathway	h_ptdinsPathway	h_ptenPathway	h_rasPathway	h_telPathway	h_tffPathway	h_trkaPathway
ALAD	h_ahspPathway
ALAS1	h_ahspPathway
ALAS2	h_ahspPathway
ALDH4A1	h_argininecPathway
ALDOA	h_mta3Pathway
ALDOB	h_glycolysisPathway
ALOX5AP	h_eicosanoidPathway
ALOX5	h_eicosanoidPathway
ALPI	h_HivnefPathway	h_deathPathway
ALPL	h_npp1Pathway
ANK3	h_PDZsPathway
ANP32F	h_setPathway
ANPEP	h_SARSpathway	h_dcPathway
ANXA1	h_gcrPathway
APAF1	h_HivnefPathway	h_caspasePathway	h_chemicalPathway	h_d4gdiPathway	h_deathPathway	h_hsp27Pathway	h_mitochondriaPathway	h_p53Pathway	h_tffPathway
APC	h_alkPathway	h_gsk3Pathway	h_pitx2Pathway	h_ps1Pathway	h_tgfbPathway	h_wntPathway
APEX1	h_setPathway
APLP1	h_prionPathway
APOA1	h_pparaPathway
APOA2	h_pparaPathway
APP	h_appPathway	h_p35alzheimersPathway	h_plateletAppPathway
ARAF	h_mapkPathway
ARF1	h_arapPathway	h_ptdinsPathway
ARFGAP1	h_arapPathway
ARFGAP3	h_arapPathway
ARFGEF1	h_arapPathway
ARFGEF2	h_arapPathway
ARFIP2	h_rac1Pathway
ARG1	h_argininecPathway
ARHGAP1	h_rhoPathway
ARHGAP4	h_rhoPathway
ARHGAP5	h_d4gdiPathway	h_ecmPathway	h_myosinPathway	h_rhoPathway
ARHGAP6	h_rhoPathway
ARHGDIB	h_HivnefPathway	h_caspasePathway	h_d4gdiPathway	h_fasPathway	h_tnfr1Pathway
ARHGEF11	h_rhoPathway
ARHGEF1	h_Par1Pathway	h_myosinPathway	h_rhoPathway
ARHGEF6	h_agrPathway
ARID1A	h_hSWI-SNFpathway	h_vdrPathway
ARNT	h_acrPathway	h_eponfkbPathway	h_hifPathway	h_vegfPathway
ARNTL	h_circadianPathway
ARRB1	h_agpcrPathway	h_bArrestin-srcPathway	h_bArrestinPathway	h_barr-mapkPathway
ASAH1	h_edg1Pathway
ASPH	h_hifPathway
ATF1	h_stressPathway
ATP5A1	h_etcPathway
ATR	h_atrbrcaPathway	h_g1Pathway	h_g2Pathway	h_plk3Pathway
AURKA	h_ranMSpathway
AVP	h_hdacPathway
AXIN1	h_alkPathway	h_gsk3Pathway	h_pitx2Pathway	h_ps1Pathway	h_wntPathway
B2M	h_ctlPathway	h_mhcPathway	h_nkcellsPathway
B3GALT1	h_aMANpathway
B3GALT2	h_aMANpathway
BAAT	h_cb1rPathway
BACE1	h_appPathway
BAD	h_achPathway	h_aktPathway	h_badPathway	h_ceramidePathway	h_chemicalPathway	h_gleevecpathway	h_igf1rPathway	h_il2rbPathway	h_ptdinsPathway	h_rasPathway	h_tffPathway
BAG4	h_HivnefPathway	h_soddPathway	h_tnfr1Pathway
BAIAP2	h_rhoPathway
BAK1	h_mitochondriaPathway
BARD1	h_bard1Pathway
BAX	h_badPathway	h_ceramidePathway	h_chemicalPathway	h_mitochondriaPathway	h_p53Pathway	h_p53hypoxiaPathway
BAZ1B	h_vdrPathway
BCAR1	h_cell2cellPathway	h_cxcr4Pathway	h_integrinPathway	h_ptenPathway	h_pyk2Pathway
BCKDK	h_methioninepathway
BCL2	h_HivnefPathway	h_badPathway	h_ceramidePathway	h_chemicalPathway	h_deathPathway	h_hsp27Pathway	h_il2rbPathway	h_il7Pathway	h_keratinocytePathway	h_melanocytepathway	h_mitochondriaPathway	h_p53Pathway	h_prionPathway	h_telPathway
BCL2L1	h_aifPathway	h_badPathway	h_chemicalPathway	h_il2rbPathway	h_mitochondriaPathway	h_rasPathway
BCR	h_gleevecpathway	h_integrinPathway
BDKRB2	h_no1Pathway
BDP1	h_RNApol3Pathway
BID	h_HivnefPathway	h_chemicalPathway	h_deathPathway	h_mitochondriaPathway
BIK	h_mitochondriaPathway
BIRC2	h_caspasePathway	h_mitochondriaPathway
BIRC3	h_HivnefPathway	h_caspasePathway	h_mitochondriaPathway	h_soddPathway
BLNK	h_bcrPathway
BLVRA	h_il10Pathway
BMP10	h_alkPathway
BMP2	h_alkPathway
BMP4	h_alkPathway
BMP5	h_alkPathway
BMP7	h_alkPathway
BMPR2	h_alkPathway
BRAF	h_mapkPathway
BRCA1	h_atmPathway	h_atrbrcaPathway	h_bard1Pathway	h_carm-erPathway	h_g2Pathway
BRCA2	h_atrbrcaPathway
BRF1	h_RNApol3Pathway
BTG2	h_btg2Pathway
BTK	h_bcrPathway	h_fcer1Pathway	h_ptdinsPathway
BTRC	h_ps1Pathway	h_wntPathway
C1QA	h_classicPathway	h_compPathway
C1R	h_classicPathway	h_compPathway
C1S	h_classicPathway	h_compPathway
C2	h_classicPathway	h_compPathway	h_lectinPathway
C2orf42	h_WNVpathway
C3	h_LairPathway	h_alternativePathway	h_classicPathway	h_compPathway	h_lectinPathway
C4A	h_classicPathway	h_compPathway	h_lectinPathway
C5	h_LairPathway	h_alternativePathway	h_classicPathway	h_compPathway	h_granulocytesPathway	h_lectinPathway
C6	h_LairPathway	h_alternativePathway	h_classicPathway	h_compPathway	h_lectinPathway
C7	h_LairPathway	h_alternativePathway	h_classicPathway	h_compPathway	h_lectinPathway
C8A	h_alternativePathway	h_classicPathway	h_compPathway	h_lectinPathway
C9	h_alternativePathway	h_classicPathway	h_compPathway	h_lectinPathway
C9orf31	h_HivnefPathway	h_ecmPathway	h_rhoPathway
CABIN1	h_hdacPathway	h_mef2dPathway
CALR	h_nfatPathway
CAMK1	h_At1rPathway	h_CaCaMPathway	h_Ccr5Pathway	h_MITRPathway	h_bcrPathway	h_biopeptidesPathway	h_calcineurinPathway	h_fMLPpathway	h_fcer1Pathway	h_gcrPathway	h_gpcrPathway	h_hdacPathway	h_mef2dPathway	h_ndkDynaminPathway	h_nfatPathway	h_no1Pathway	h_nos1Pathway	h_pgc1aPathway	h_pyk2Pathway	h_tcrPathway	h_vipPathway
CAMK2G	h_CaCaMPathway	h_biopeptidesPathway	h_crebPathway	h_pgc1aPathway	h_stathminPathway
CAMK4	h_CaCaMPathway	h_nfatPathway	h_pgc1aPathway	h_stathminPathway
CAMKK2	h_CaCaMPathway
CANX	h_eradPathway
CAP1	h_mPRPathway
CAPN1	h_integrinPathway	h_mCalpainPathway	h_p35alzheimersPathway	h_ucalpainPathway
CAPN2	h_mCalpainPathway	h_mef2dPathway
CARM1	h_carm-erPathway	h_carm1Pathway	h_her2Pathway	h_vdrPathway
CASP10	h_caspasePathway	h_d4gdiPathway	h_deathPathway	h_fasPathway
CASP1	h_caspasePathway	h_d4gdiPathway	h_il18Pathway
CASP2	h_HivnefPathway	h_caspasePathway	h_stressPathway	h_tnfr1Pathway
CASP3	h_DNAfragmentPathway	h_HivnefPathway	h_bcellsurvivalPathway	h_caspasePathway	h_chemicalPathway	h_d4gdiPathway	h_deathPathway	h_fasPathway	h_hsp27Pathway	h_mitochondriaPathway	h_tnfr1Pathway	h_tsp1Pathway
CASP4	h_caspasePathway
CASP6	h_HivnefPathway	h_caspasePathway	h_chemicalPathway	h_deathPathway	h_fasPathway	h_mitochondriaPathway
CASP7	h_DNAfragmentPathway	h_HivnefPathway	h_bcellsurvivalPathway	h_caspasePathway	h_chemicalPathway	h_deathPathway	h_fasPathway	h_mitochondriaPathway
CASP9	h_HivnefPathway	h_WNVpathway	h_aktPathway	h_caspasePathway	h_chemicalPathway	h_d4gdiPathway	h_deathPathway	h_hsp27Pathway	h_mitochondriaPathway	h_rasPathway	h_tffPathway
CAT	h_longevityPathway
CAV1	h_integrinPathway	h_no1Pathway
CBL	h_cblPathway	h_il2rbPathway	h_spryPathway
CBS	h_methioninepathway
CBX4	h_prc2Pathway
CCL11	h_CCR3Pathway	h_eosinophilsPathway	h_il5Pathway
CCL2	h_Ccr5Pathway	h_LDLpathway	h_mspPathway
CCL3	h_erythPathway	h_nktPathway
CCL4	h_Ccr5Pathway	h_nktPathway
CCL5	h_eosinophilsPathway
CCNA1	h_cellcyclePathway	h_g1Pathway	h_skp2e2fPathway
CCNB1	h_akap95Pathway	h_cellcyclePathway	h_g2Pathway	h_mPRPathway	h_ptc1Pathway	h_srcRPTPPathway	h_stathminPathway
CCNB2	h_EfpPathway
CCND1	h_RacCycDPathway	h_btg2Pathway	h_carm-erPathway	h_cellcyclePathway	h_g1Pathway	h_gsk3Pathway	h_p53Pathway	h_wntPathway
CCND2	h_cellcyclePathway
CCND3	h_cellcyclePathway
CCNE1	h_RacCycDPathway	h_cellcyclePathway	h_fbw7Pathway	h_g1Pathway	h_mcmPathway	h_p27Pathway	h_p53Pathway	h_skp2e2fPathway
CCNH	h_cellcyclePathway	h_ptc1Pathway
CCR1	h_nktPathway
CCR2	h_nktPathway
CCR3	h_CCR3Pathway	h_eosinophilsPathway	h_il5Pathway	h_nktPathway
CCR4	h_nktPathway
CCR5	h_Ccr5Pathway	h_IL12Pathway	h_nktPathway	h_no2il12Pathway	h_tcapoptosisPathway
CCR7	h_nktPathway
CCT4	h_bcellsurvivalPathway
CD14	h_gsk3Pathway	h_tollPathway
CD247	h_CSKPathway	h_IL12Pathway	h_ctlPathway	h_ctla4Pathway	h_il17Pathway	h_no2il12Pathway	h_stathminPathway	h_tcapoptosisPathway	h_tcrPathway	h_tcraPathway	h_tcrmolecule	h_tcytotoxicPathway	h_thelperPathway	h_tob1Pathway
CD28	h_asbcellPathway	h_bbcellPathway	h_ctla4Pathway	h_nktPathway	h_tcapoptosisPathway	h_tcytotoxicPathway	h_th1th2Pathway	h_thelperPathway	h_tob1Pathway
CD2	h_dcPathway	h_il17Pathway	h_no2il12Pathway	h_stathminPathway	h_tcytotoxicPathway	h_thelperPathway
CD33	h_dcPathway
CD34	h_il17Pathway	h_lympathway
CD36	h_tsp1Pathway
CD3D	h_CSKPathway	h_IL12Pathway	h_ctlPathway	h_ctla4Pathway	h_il17Pathway	h_tcapoptosisPathway	h_tcrPathway	h_tcraPathway	h_tcrmolecule	h_tcytotoxicPathway	h_thelperPathway	h_tob1Pathway
CD3E	h_CSKPathway	h_IL12Pathway	h_ctlPathway	h_ctla4Pathway	h_il17Pathway	h_tcapoptosisPathway	h_tcrPathway	h_tcraPathway	h_tcrmolecule	h_tcytotoxicPathway	h_thelperPathway	h_tob1Pathway
CD3G	h_CSKPathway	h_IL12Pathway	h_ctlPathway	h_ctla4Pathway	h_il17Pathway	h_tcapoptosisPathway	h_tcrPathway	h_tcraPathway	h_tcrmolecule	h_tcytotoxicPathway	h_thelperPathway	h_tob1Pathway
CD40	h_asbcellPathway	h_bbcellPathway	h_blymphocytePathway	h_cd40Pathway	h_dcPathway	h_th1th2Pathway
CD40LG	h_asbcellPathway	h_bbcellPathway	h_cd40Pathway	h_nktPathway	h_th1th2Pathway
CD44	h_lymphocytePathway	h_monocytePathway	h_neutrophilPathway
CD4	h_CSKPathway	h_asbcellPathway	h_bbcellPathway	h_il17Pathway	h_il5Pathway	h_inflamPathway	h_nktPathway	h_no2il12Pathway	h_stemPathway	h_tcapoptosisPathway	h_tcraPathway	h_thelperPathway	h_vifPathway
CD58	h_il17Pathway
CD5	h_dcPathway
CD74	h_mhcPathway
CD79A	h_bcrPathway	h_bcrmolecule	h_ctcfPathway
CD79B	h_bcrPathway	h_bcrmolecule	h_ctcfPathway
CD7	h_dcPathway
CD80	h_asbcellPathway	h_blymphocytePathway	h_ctla4Pathway
CD86	h_ctla4Pathway	h_th1th2Pathway
CD8A	h_il17Pathway	h_stemPathway	h_tcytotoxicPathway
CDC25A	h_cellcyclePathway	h_g1Pathway
CDC25C	h_mPRPathway	h_plk3Pathway
CDC2	h_akap95Pathway	h_akapCentrosomePathway	h_cdc25Pathway	h_cellcyclePathway	h_g1Pathway	h_g2Pathway	h_mPRPathway	h_ptc1Pathway	h_rbPathway	h_sam68Pathway	h_srcRPTPPathway	h_stathminPathway
CDC34	h_fbw7Pathway	h_g2Pathway	h_skp2e2fPathway
CDC42	h_agrPathway	h_cdc42racPathway	h_malPathway	h_p38mapkPathway	h_rasPathway	h_salmonellaPathway
CDC6	h_mcmPathway
CDH1	h_ctbp1Pathway	h_mta3Pathway	h_tgfbPathway
CDK2	h_RacCycDPathway	h_cellcyclePathway	h_fbw7Pathway	h_g1Pathway	h_mcmPathway	h_p27Pathway	h_p53Pathway	h_rbPathway	h_skp2e2fPathway
CDK4	h_RacCycDPathway	h_cellcyclePathway	h_g1Pathway	h_p53Pathway	h_rbPathway
CDK5	h_Lis1Pathway	h_biopeptidesPathway	h_cdk5Pathway	h_ck1Pathway	h_fosbPathway	h_p35alzheimersPathway	h_rac1Pathway	h_reelinPathway
CDK5R1	h_Lis1Pathway	h_cdk5Pathway	h_ck1Pathway	h_p35alzheimersPathway	h_rac1Pathway	h_reelinPathway
CDK6	h_EfpPathway	h_RacCycDPathway	h_cellcyclePathway	h_g1Pathway
CDK7	h_cellcyclePathway	h_rarPathway
CDKN1B	h_RacCycDPathway	h_cellcyclePathway	h_ctcfPathway	h_g1Pathway	h_mcmPathway	h_p27Pathway	h_ptenPathway
CDKN2A	h_arfPathway	h_cellcyclePathway	h_ctcfPathway	h_g1Pathway
CDKN2B	h_cellcyclePathway	h_g1Pathway
CDKN2C	h_cellcyclePathway
CDKN2D	h_cellcyclePathway	h_g2Pathway
CDT1	h_mcmPathway
CEBPA	h_keratinocytePathway	h_mapkPathway
CEBPB	h_il6Pathway
CENTD1	h_arapPathway
CENTD2	h_arapPathway
CFB	h_alternativePathway	h_compPathway
CFD	h_alternativePathway	h_compPathway
CFL1	h_CCR3Pathway	h_rac1Pathway	h_rhoPathway
CFLAR	h_HivnefPathway	h_deathPathway	h_fasPathway	h_il2rbPathway
CFP	h_alternativePathway
CFTR	h_cftrPathway
CHAF1A	h_vdrPathway
CHEK1	h_atmPathway	h_atrbrcaPathway	h_cdc25Pathway	h_g2Pathway	h_plk3Pathway	h_rbPathway
CHEK2	h_atmPathway	h_atrbrcaPathway	h_g2Pathway	h_plk3Pathway
CHN1	h_rac1Pathway
CHRD	h_alkPathway
CHRM1	h_agrPathway	h_botulinPathway	h_no1Pathway	h_tubbyPathway
CHRNB1	h_achPathway
CHRNG	h_achPathway
CHUK	h_41bbPathway	h_HivnefPathway	h_RELAPathway	h_RacCycDPathway	h_aktPathway	h_cd40Pathway	h_deathPathway	h_il1rPathway	h_keratinocytePathway	h_mapkPathway	h_nfkbPathway	h_nthiPathway	h_rasPathway	h_rnaPathway	h_stressPathway	h_tall1Pathway	h_tnfr2Pathway	h_tollPathway	h_vipPathway
CITED2	h_pparaPathway
CKM	h_SARSpathway
CKS1B	h_p27Pathway
CLIP1	h_Lis1Pathway
CLOCK	h_circadianPathway
CMA1	h_ace2Pathway
CNOT7	h_btg2Pathway
CNR1	h_cb1rPathway
CNR2	h_cb1rPathway
COL4A6	h_ace2Pathway	h_amiPathway	h_intrinsicPathway	h_npp1Pathway	h_plateletAppPathway	h_vitCBPathway
COPA	h_arapPathway
COPS2	h_vdrPathway
COPS5	h_hifPathway
CORIN	h_gcrPathway
CPOX	h_ahspPathway
CPSF3	h_cpsfPathway
CPT1A	h_cptPathway	h_leptinPathway
CPT2	h_cptPathway
CR1	h_blymphocytePathway
CR2	h_blymphocytePathway
CRADD	h_HivnefPathway	h_stressPathway	h_tnfr1Pathway
CREB1	h_CaCaMPathway	h_HBxPathway	h_HuntingtonPathway	h_arenrf2Pathway	h_carm1Pathway	h_crebPathway	h_dreampathway	h_erk5Pathway	h_gpcrPathway	h_hcmvPathway	h_hifPathway	h_mapkPathway	h_melanocytepathway	h_p38mapkPathway
CREBBP	h_CSKPathway	h_HuntingtonPathway	h_RELAPathway	h_carm-erPathway	h_carm1Pathway	h_il7Pathway	h_nfatPathway	h_nthiPathway	h_pcafpathway	h_pelp1Pathway	h_pitx2Pathway	h_pmlPathway	h_pparaPathway	h_ppargPathway	h_setPathway	h_tgfbPathway	h_vdrPathway	h_wntPathway
CREM	h_cremPathway	h_dreampathway
CRK	h_cxcr4Pathway	h_metPathway
CRKL	h_gleevecpathway	h_il2rbPathway	h_integrinPathway	h_metPathway	h_pyk2Pathway
CRY2	h_circadianPathway
CRYZ	h_arenrf2Pathway
CSF1	h_LDLpathway	h_etsPathway	h_inflamPathway	h_mspPathway	h_stemPathway
CSF1R	h_cblPathway	h_etsPathway
CSF2	h_dcPathway	h_eosinophilsPathway	h_erythPathway	h_inflamPathway	h_nktPathway	h_stemPathway
CSF2RB	h_il3Pathway
CSF3	h_erythPathway	h_granulocytesPathway	h_il17Pathway	h_inflamPathway	h_stemPathway
CS	h_malatexPathway
CSK	h_CSKPathway	h_cell2cellPathway	h_integrinPathway	h_srcRPTPPathway
CSNK1A1	h_nfatPathway	h_p35alzheimersPathway	h_p53hypoxiaPathway	h_wntPathway
CSNK1D	h_ck1Pathway
CSNK1E	h_circadianPathway
CSNK2A1	h_Lis1Pathway	h_TPOPathway	h_egfPathway	h_epoPathway	h_igf1Pathway	h_il2Pathway	h_il6Pathway	h_insulinPathway	h_ngfPathway	h_pdgfPathway	h_wntPathway
CSTF3	h_cpsfPathway
CTBP1	h_ctbp1Pathway	h_wntPathway
CTCF	h_ctcfPathway
CTF1	h_nfatPathway
CTH	h_methioninepathway
CTLA4	h_ctla4Pathway
CTNNA1	h_cell2cellPathway
CTNNB1	h_alkPathway	h_cell2cellPathway	h_gsk3Pathway	h_pitx2Pathway	h_ps1Pathway	h_tffPathway	h_wntPathway
CTSD	h_mta3Pathway
CTTN	h_agrPathway
CUL1	h_eradPathway	h_fbw7Pathway	h_p27Pathway	h_skp2e2fPathway
CUZD1	h_cdMacPathway
CXCL12	h_Ccr5Pathway	h_cxcr4Pathway
CXCR3	h_IL12Pathway	h_mCalpainPathway	h_nktPathway	h_no2il12Pathway
CXCR4	h_Ccr5Pathway	h_cxcr4Pathway	h_nktPathway	h_vifPathway
CYCS	h_HivnefPathway	h_aifPathway	h_caspasePathway	h_ceramidePathway	h_chemicalPathway	h_d4gdiPathway	h_deathPathway	h_etcPathway	h_hsp27Pathway	h_mitochondriaPathway	h_tffPathway
CYP1A2	h_AcetaminophenPathway	h_nuclearRsPathway
CYP24A1	h_nuclearRsPathway
CYP26A1	h_nuclearRsPathway
CYP27B1	h_nuclearRsPathway
CYP2B6	h_nuclearRsPathway
CYP2C9	h_nuclearRsPathway
CYP2E1	h_AcetaminophenPathway	h_nuclearRsPathway
CYP2J2	h_eicosanoidPathway
CYP3A4	h_nuclearRsPathway
CYP4A22	h_nuclearRsPathway
CYP4B1	h_nuclearRsPathway
CYP4V2	h_intrinsicPathway
CYP7A1	h_fxrPathway	h_nuclearRsPathway
CYP8B1	h_nuclearRsPathway
CYSLTR1	h_eicosanoidPathway
CYSLTR2	h_eicosanoidPathway
CYTH1	h_arapPathway
CYTH2	h_arapPathway
CYTH3	h_arapPathway
CYTH4	h_arapPathway
DAB1	h_reelinPathway
DAG1	h_agrPathway
DAXX	h_HivnefPathway	h_fasPathway	h_hsp27Pathway	h_keratinocytePathway	h_mapkPathway	h_p38mapkPathway	h_pmlPathway
DCTN1	h_Lis1Pathway
DCX	h_Lis1Pathway
DDEF1	h_arapPathway
DDEF2	h_arapPathway
DDIT3	h_p38mapkPathway
DDX20	h_etsPathway
DDX5	h_akap95Pathway
DFFA	h_DNAfragmentPathway	h_HivnefPathway	h_caspasePathway	h_deathPathway	h_fasPathway	h_mitochondriaPathway	h_setPathway	h_tnfr1Pathway
DFFB	h_DNAfragmentPathway	h_HivnefPathway	h_caspasePathway	h_deathPathway	h_fasPathway	h_mitochondriaPathway	h_setPathway	h_tnfr1Pathway
DHFR	h_g1Pathway
DIABLO	h_mitochondriaPathway
DIAPH1	h_ecmPathway	h_malPathway	h_rhoPathway
DICER1	h_dicerPathway
DKK1	h_wnt-lrp6Pathway
DKK2	h_wnt-lrp6Pathway
DLG1	h_PDZsPathway
DLG2	h_PDZsPathway
DLG3	h_PDZsPathway
DLG4	h_PDZsPathway	h_nos1Pathway
DLL1	h_hesPathway	h_notchpathway	h_ps1Pathway
DLL3	h_hesPathway
DMD	h_agrPathway
DNAJA3	h_tidPathway
DNAJB1	h_p53hypoxiaPathway	h_prionPathway
DNAJB6	h_prionPathway
DNAJC3	h_rnaPathway
DNM1	h_bArrestin-srcPathway	h_bArrestinPathway	h_barr-mapkPathway	h_gabaPathway	h_ndkDynaminPathway
DNMBP	h_mta3Pathway
DOCK1	h_metPathway
DPF2	h_bcellsurvivalPathway
DRD1	h_ck1Pathway
DRD2	h_ck1Pathway
DUSP1	h_cd40Pathway	h_dspPathway	h_nthiPathway	h_pparaPathway	h_tnfr2Pathway
DUSP2	h_dspPathway
DUSP4	h_dspPathway
DUSP6	h_dspPathway
DUSP8	h_dspPathway
DUSP9	h_dspPathway
DUT	h_pparaPathway
DVL1	h_agrPathway	h_alkPathway	h_gsk3Pathway	h_hesPathway	h_pitx2Pathway	h_ps1Pathway	h_wntPathway
DYNLL1	h_Lis1Pathway
DYRK1A	h_shhPathway
E2F1	h_RacCycDPathway	h_arfPathway	h_cellcyclePathway	h_etsPathway	h_fbw7Pathway	h_g1Pathway	h_il2rbPathway	h_p27Pathway	h_p53Pathway	h_skp2e2fPathway
E2F4	h_etsPathway
ECSIT	h_il1rPathway	h_tollPathway
EDEM1	h_eradPathway
EDN1	h_cardiacegfPathway	h_hifPathway	h_nfatPathway
EDNRA	h_cardiacegfPathway
EEA1	h_eea1Pathway	h_ptdinsPathway
EED	h_prc2Pathway
EEF1A1	h_WNVpathway
EEF2	h_eifPathway
EGF	h_ErbB3Pathway	h_cardiacegfPathway	h_cblPathway	h_eea1Pathway	h_egfPathway	h_egfr_smrtePathway	h_keratinocytePathway	h_mCalpainPathway	h_spryPathway
EGFR	h_At1rPathway	h_ErbB3Pathway	h_agrPathway	h_cardiacegfPathway	h_cblPathway	h_eea1Pathway	h_egfPathway	h_egfr_smrtePathway	h_erkPathway	h_her2Pathway	h_keratinocytePathway	h_mCalpainPathway	h_spryPathway	h_telPathway	h_tffPathway
EGR1	h_cdk5Pathway
EGR2	h_vipPathway
EGR3	h_vipPathway
EHHADH	h_pparaPathway
EIF1	h_eifPathway
EIF2AK2	h_eif2Pathway	h_gsk3Pathway	h_ranklPathway	h_rnaPathway	h_tollPathway
EIF2AK3	h_eif2Pathway
EIF2AK4	h_eif2Pathway
EIF2B5	h_eif2Pathway	h_igf1mtorpathway	h_vegfPathway
EIF2C1	h_dicerPathway
EIF2C2	h_dicerPathway
EIF2C3	h_dicerPathway
EIF2C4	h_dicerPathway
EIF2S1	h_chemicalPathway	h_eif2Pathway	h_eifPathway	h_igf1mtorpathway	h_rnaPathway
EIF2S2	h_eif2Pathway	h_igf1mtorpathway	h_rnaPathway
EIF2S3	h_eif2Pathway	h_igf1mtorpathway
EIF3A	h_eifPathway	h_iresPathway	h_mTORPathway
EIF4B	h_mTORPathway
EIF4EBP1	h_eif4Pathway	h_igf1mtorpathway	h_mTORPathway
EIF4E	h_SARSpathway	h_eif4Pathway	h_eifPathway	h_igf1mtorpathway	h_iresPathway	h_mTORPathway
EIF4G1	h_eif4Pathway	h_iresPathway	h_mTORPathway
EIF5	h_eif2Pathway	h_eifPathway
EIF6	h_eifPathway
ELA1	h_pepiPathway
ELAVL1	h_vegfPathway
ELSPBP1	h_nfatPathway
ENDOG	h_DNAfragmentPathway	h_mitochondriaPathway
ENG	h_cblPathway
ENO1	h_glycolysisPathway
ENPP1	h_npp1Pathway
EP300	h_RELAPathway	h_carm-erPathway	h_carm1Pathway	h_g2Pathway	h_her2Pathway	h_hifPathway	h_il7Pathway	h_mef2dPathway	h_melanocytepathway	h_nthiPathway	h_p53hypoxiaPathway	h_pelp1Pathway	h_pitx2Pathway	h_pparaPathway	h_ppargPathway	h_tgfbPathway	h_vdrPathway
EPB41	h_PDZsPathway
EPB42	h_anthraxPathway
EPHA4	h_ephA4Pathway
EPHB1	h_ephA4Pathway
EPHX1	h_eicosanoidPathway
EPN1	h_ndkDynaminPathway
EPO	h_epoPathway	h_eponfkbPathway	h_erythPathway	h_hifPathway	h_stemPathway
EPOR	h_epoPathway	h_eponfkbPathway
EPS15	h_ndkDynaminPathway
EPYC	h_slrpPathway
ERAF	h_ahspPathway	h_amiPathway
ERBB3	h_ErbB3Pathway	h_her2Pathway
ERBB4	h_erbB4pathway	h_her2Pathway
ERCC3	h_carm-erPathway	h_hSWI-SNFpathway	h_rarrxrPathway
ESR1	h_EfpPathway	h_carm-erPathway	h_her2Pathway	h_mta3Pathway	h_pelp1Pathway
ESRRA	h_pgc1aPathway
ETS1	h_etsPathway	h_keratinocytePathway
ETV3	h_etsPathway
ETV5	h_IL12Pathway
EZH1	h_prc2Pathway
EZH2	h_prc2Pathway
EZR	h_cftrPathway	h_mCalpainPathway	h_ucalpainPathway
F10	h_amiPathway	h_extrinsicPathway	h_intrinsicPathway
F11	h_intrinsicPathway	h_plateletAppPathway
F12	h_intrinsicPathway
F13A1	h_fibrinolysisPathway
F2	h_Par1Pathway	h_amiPathway	h_biopeptidesPathway	h_dbpbPathway	h_extrinsicPathway	h_fibrinolysisPathway	h_intrinsicPathway	h_nfatPathway	h_plateletAppPathway	h_sppaPathway
F2R	h_amiPathway	h_extrinsicPathway	h_fibrinolysisPathway	h_intrinsicPathway
F2RL3	h_Par1Pathway	h_sppaPathway
F3	h_extrinsicPathway
F5	h_extrinsicPathway	h_intrinsicPathway
F7	h_amiPathway	h_extrinsicPathway
F8	h_intrinsicPathway
F9	h_intrinsicPathway	h_plateletAppPathway
FABP1	h_pparaPathway
FABP6	h_fxrPathway
FADD	h_HivnefPathway	h_RELAPathway	h_ceramidePathway	h_deathPathway	h_fasPathway	h_nfkbPathway	h_soddPathway	h_tnfr1Pathway
FAF1	h_fasPathway
FANCA	h_atrbrcaPathway	h_bard1Pathway
FANCC	h_atrbrcaPathway	h_bard1Pathway
FANCD2	h_atrbrcaPathway	h_bard1Pathway
FANCE	h_atrbrcaPathway	h_bard1Pathway
FANCF	h_atrbrcaPathway	h_bard1Pathway
FANCG	h_atrbrcaPathway	h_bard1Pathway
FAS	h_HivnefPathway	h_asbcellPathway	h_bbcellPathway	h_ctlPathway	h_fasPathway	h_hsp27Pathway	h_il2rbPathway	h_keratinocytePathway	h_pmlPathway	h_tcapoptosisPathway
FASLG	h_HivnefPathway	h_achPathway	h_aktPathway	h_asbcellPathway	h_bbcellPathway	h_ctlPathway	h_fasPathway	h_hsp27Pathway	h_il2rbPathway	h_keratinocytePathway	h_pmlPathway	h_ptenPathway	h_tcapoptosisPathway
FBL	h_SARSpathway
FBXO2	h_eradPathway
FBXW4P1	h_gleevecpathway	h_integrinPathway
FBXW7	h_fbw7Pathway
FCER1A	h_fcer1Pathway
FCER1G	h_fcer1Pathway
FECH	h_ahspPathway
FGF1	h_btg2Pathway
FGF2	h_nfatPathway
FGR	h_bArrestin-srcPathway
FHL2	h_p53hypoxiaPathway
FHL5	h_cremPathway
FKBP1A	h_mTORPathway	h_nfatPathway
FLT3	h_erythPathway
FOSB	h_fosbPathway
FOS	h_Ccr5Pathway	h_TPOPathway	h_arenrf2Pathway	h_bcellsurvivalPathway	h_bcrPathway	h_cardiacegfPathway	h_cdMacPathway	h_dreampathway	h_egfPathway	h_epoPathway	h_etsPathway	h_fcer1Pathway	h_gleevecpathway	h_gpcrPathway	h_igf1Pathway	h_il2Pathway	h_il2rbPathway	h_il3Pathway	h_il6Pathway	h_insulinPathway	h_mapkPathway	h_ngfPathway	h_pdgfPathway	h_ranklPathway	h_tcrPathway	h_tollPathway	h_tsp1Pathway
FOSL1	h_ranklPathway
FOSL2	h_ranklPathway
FOXO1	h_aktPathway
FOXO3	h_achPathway	h_aktPathway	h_longevityPathway	h_ptenPathway
FOXO4	h_aktPathway	h_rasPathway
FPR1	h_fMLPpathway
FRAP1	h_bcellsurvivalPathway	h_ctcfPathway	h_eif4Pathway	h_igf1mtorpathway	h_mTORPathway	h_stat3Pathway
FRAT1	h_wntPathway
FSHB	h_cremPathway
FSHR	h_cremPathway
FURIN	h_notchpathway
FUT7	h_aMANpathway
FXYD2	h_arenrf2Pathway
FYN	h_biopeptidesPathway	h_ecmPathway	h_ephA4Pathway	h_il7Pathway	h_integrinPathway	h_reelinPathway	h_tcrPathway	h_tcraPathway	h_tsp1Pathway
FZD1	h_alkPathway	h_gsk3Pathway	h_hesPathway	h_pitx2Pathway	h_ps1Pathway	h_wnt-lrp6Pathway	h_wntPathway
GAB1	h_metPathway
GABARAP	h_gabaPathway
GABRA3	h_flumazenilPathway	h_gabaPathway
GADD45A	h_atmPathway	h_g2Pathway	h_p53Pathway	h_p53hypoxiaPathway
GALE	h_g1pPathway
GALK1	h_g1pPathway
GALT	h_g1pPathway
GANAB	h_eradPathway
GATA1	h_ahspPathway
GATA3	h_GATA3pathway
GATA4	h_alkPathway	h_hopPathway	h_nfatPathway
GBF1	h_arapPathway
GFAP	h_prionPathway
GH1	h_aktPathway	h_ghPathway	h_ghrelinPathway	h_longevityPathway	h_tffPathway
GHR	h_aktPathway	h_eif4Pathway	h_ghPathway	h_longevityPathway	h_tffPathway
GHRH	h_ghrelinPathway
GHRL	h_ghrelinPathway
GIT2	h_agrPathway
GJA1	h_gsk3Pathway
GLI1	h_shhPathway
GLI2	h_shhPathway
GLI3	h_shhPathway
GLS	h_argininecPathway
GLUD1	h_argininecPathway
GLYCAM1	h_lympathway
GNA11	h_biopeptidesPathway
GNA12	h_akap13Pathway
GNA13	h_Par1Pathway	h_myosinPathway
GNA15	h_fMLPpathway
GNAI1	h_Par1Pathway	h_biopeptidesPathway	h_cxcr4Pathway	h_edg1Pathway	h_gpcrPathway	h_gsk3Pathway	h_mPRPathway	h_sppaPathway
GNAQ	h_At1rPathway	h_CCR3Pathway	h_Ccr5Pathway	h_Par1Pathway	h_calcineurinPathway	h_cxcr4Pathway	h_gpcrPathway	h_myosinPathway	h_pkcPathway	h_pyk2Pathway	h_tubbyPathway	h_vipPathway
GNAS	h_CCR3Pathway	h_CSKPathway	h_agpcrPathway	h_bArrestin-srcPathway	h_bArrestinPathway	h_barr-mapkPathway	h_cftrPathway	h_chrebpPathway	h_crebPathway	h_cremPathway	h_erkPathway	h_gcrPathway	h_gpcrPathway	h_gsPathway	h_mPRPathway	h_plcePathway	h_raccPathway
GNB1	h_CCR3Pathway	h_CSKPathway	h_Par1Pathway	h_agpcrPathway	h_bArrestin-srcPathway	h_bArrestinPathway	h_barr-mapkPathway	h_biopeptidesPathway	h_chrebpPathway	h_cxcr4Pathway	h_edg1Pathway	h_erkPathway	h_fMLPpathway	h_gcrPathway	h_gpcrPathway	h_gsPathway	h_mPRPathway	h_myosinPathway	h_raccPathway	h_sppaPathway	h_tubbyPathway
GNGT1	h_CCR3Pathway	h_CSKPathway	h_Par1Pathway	h_agpcrPathway	h_bArrestin-srcPathway	h_bArrestinPathway	h_barr-mapkPathway	h_biopeptidesPathway	h_chrebpPathway	h_cxcr4Pathway	h_edg1Pathway	h_erkPathway	h_fMLPpathway	h_gcrPathway	h_gpcrPathway	h_gsPathway	h_mPRPathway	h_myosinPathway	h_raccPathway	h_sppaPathway	h_tubbyPathway
GOT1	h_malatePathway
GPD2	h_etcPathway
GPHN	h_gabaPathway
GPI	h_glycolysisPathway
GPLD1	h_arapPathway
GPR37	h_parkinPathway
GPT	h_SARSpathway
GPX1	h_flumazenilPathway	h_freePathway
GRASP	h_ptdinsPathway
GRB2	h_At1rPathway	h_HBxPathway	h_TPOPathway	h_bcrPathway	h_biopeptidesPathway	h_cblPathway	h_crebPathway	h_ctla4Pathway	h_egfPathway	h_epoPathway	h_erk5Pathway	h_erkPathway	h_fcer1Pathway	h_ghPathway	h_gleevecpathway	h_her2Pathway	h_igf1Pathway	h_igf1rPathway	h_il2Pathway	h_il2rbPathway	h_il3Pathway	h_il4Pathway	h_il6Pathway	h_insulinPathway	h_integrinPathway	h_mapkPathway	h_metPathway	h_ngfPathway	h_p38mapkPathway	h_pdgfPathway	h_ptenPathway	h_pyk2Pathway	h_spryPathway	h_srcRPTPPathway	h_tcrPathway	h_tffPathway	h_trkaPathway
GREB1	h_mta3Pathway
GRIA2	h_fosbPathway
GRIN1	h_PDZsPathway	h_eponfkbPathway
GRIN2D	h_nos1Pathway
GRIP1	h_carm-erPathway	h_her2Pathway
GRK1	h_rhodopsinPathway
GRK4	h_agpcrPathway
GRM1	h_ck1Pathway
GRN	h_pepiPathway
GSK3A	h_ptdinsPathway
GSK3B	h_alkPathway	h_eif2Pathway	h_g1Pathway	h_gsk3Pathway	h_hesPathway	h_igf1mtorpathway	h_nfatPathway	h_p35alzheimersPathway	h_pitx2Pathway	h_ps1Pathway	h_ptdinsPathway	h_shhPathway	h_wntPathway
GSR	h_freePathway
GSS	h_freePathway
GSTA2	h_arenrf2Pathway
GSTP1	h_mrpPathway
GTF2A1	h_carm-erPathway	h_hSWI-SNFpathway	h_rarrxrPathway
GTF2B	h_hSWI-SNFpathway	h_rarrxrPathway
GTF2E1	h_carm-erPathway	h_hSWI-SNFpathway	h_rarrxrPathway
GTF2F1	h_carm-erPathway	h_hSWI-SNFpathway	h_rarrxrPathway
GTF3A	h_bArrestinPathway	h_ndkDynaminPathway	h_ptdinsPathway
GTF3C1	h_RNApol3Pathway
GTF3C3	h_RNApol3Pathway
GTF3C4	h_RNApol3Pathway
GTF3C5	h_RNApol3Pathway
GUCA1A	h_rhodopsinPathway
GUK1	h_PDZsPathway
GZMA	h_setPathway
GZMB	h_DNAfragmentPathway	h_caspasePathway	h_ctlPathway	h_d4gdiPathway	h_setPathway
HAND1	h_nfatPathway
HAND2	h_nfatPathway
HBB	h_ahspPathway
HBEGF	h_nfatPathway
HBXIP	h_HBxPathway
hCG_2015138	h_glycolysisPathway
HCK	h_bArrestin-srcPathway	h_vifPathway
HDAC1	h_HuntingtonPathway	h_g1Pathway	h_mef2dPathway	h_mta3Pathway	h_pitx2Pathway	h_prc2Pathway	h_ranbp2Pathway	h_tertpathway	h_vdrPathway	h_wntPathway
HDAC2	h_carm-erPathway	h_etsPathway	h_mef2dPathway	h_prc2Pathway
HDAC3	h_RELAPathway	h_rarrxrPathway
HDAC4	h_ranbp2Pathway
HDAC5	h_hdacPathway	h_pgc1aPathway
HDAC6	h_ranbp2Pathway
HDAC9	h_MITRPathway	h_ranbp2Pathway
HEATR6	h_fxrPathway
HES1	h_hesPathway
HES7	h_hesPathway
HEY2	h_hesPathway
HGF	h_metPathway
HGS	h_eea1Pathway
HIC1	h_p53hypoxiaPathway
HIF1A	h_eponfkbPathway	h_hifPathway	h_p53hypoxiaPathway	h_vegfPathway
HK1	h_glycolysisPathway
HLA-A29.1	h_ctlPathway	h_mhcPathway	h_nkcellsPathway
HLA-A	h_ctlPathway	h_mhcPathway	h_nkcellsPathway
HLA-DRA	h_CSKPathway	h_asbcellPathway	h_bbcellPathway	h_blymphocytePathway	h_ctla4Pathway	h_eosinophilsPathway	h_il5Pathway	h_inflamPathway	h_mhcPathway	h_tcraPathway	h_th1th2Pathway
HLA-DRB1	h_CSKPathway	h_asbcellPathway	h_bbcellPathway	h_blymphocytePathway	h_ctla4Pathway	h_eosinophilsPathway	h_il5Pathway	h_inflamPathway	h_mhcPathway	h_tcraPathway	h_th1th2Pathway
HLA-DRB5	h_CSKPathway	h_asbcellPathway	h_bbcellPathway	h_blymphocytePathway	h_ctla4Pathway	h_eosinophilsPathway	h_il5Pathway	h_inflamPathway	h_mhcPathway	h_tcraPathway	h_th1th2Pathway
HMBS	h_ahspPathway
HMGB1	h_DNAfragmentPathway	h_pcafpathway
HMGB2	h_DNAfragmentPathway	h_setPathway
HMGCS1	h_s1pPathway
HMGN1	h_p38mapkPathway
HMOX1	h_arenrf2Pathway	h_il10Pathway
HNF1A	h_alkPathway	h_ghPathway	h_hesPathway	h_malPathway	h_ps1Pathway	h_wntPathway
HNRPA1P5	h_WNVpathway
HOPX	h_hopPathway
HOXA7	h_keratinocytePathway
HOXB9	h_btg2Pathway
HRAS	h_At1rPathway	h_CCR3Pathway	h_HBxPathway	h_RacCycDPathway	h_TPOPathway	h_bArrestin-srcPathway	h_bcrPathway	h_biopeptidesPathway	h_cardiacegfPathway	h_cdMacPathway	h_cdk5Pathway	h_crebPathway	h_cxcr4Pathway	h_ecmPathway	h_egfPathway	h_epoPathway	h_erk5Pathway	h_erkPathway	h_etsPathway	h_fMLPpathway	h_fcer1Pathway	h_ghPathway	h_gleevecpathway	h_gpcrPathway	h_her2Pathway	h_igf1Pathway	h_igf1rPathway	h_il2Pathway	h_il2rbPathway	h_il3Pathway	h_il6Pathway	h_insulinPathway	h_integrinPathway	h_keratinocytePathway	h_longevityPathway	h_mCalpainPathway	h_mPRPathway	h_malPathway	h_mapkPathway	h_metPathway	h_nfatPathway	h_ngfPathway	h_p38mapkPathway	h_pdgfPathway	h_pmlPathway	h_pyk2Pathway	h_rasPathway	h_reckPathway	h_sam68Pathway	h_sppaPathway	h_spryPathway	h_tcrPathway	h_tffPathway	h_trkaPathway	h_vegfPathway
HSD11B1	h_vobesityPathway
HSD17B4	h_pparaPathway
HSP90AA1	h_acrPathway	h_aktPathway	h_gcrPathway	h_hifPathway	h_no1Pathway	h_p53hypoxiaPathway	h_pparaPathway	h_telPathway
HSPA1A	h_p53hypoxiaPathway	h_pparaPathway	h_tidPathway
HSPA5	h_prionPathway	h_stathminPathway
HSPB1	h_hsp27Pathway	h_mta3Pathway	h_p38mapkPathway
HTR2C	h_tubbyPathway
HTT	h_HuntingtonPathway
HUS1	h_atrbrcaPathway
IBSP	h_npp1Pathway
ICAM1	h_LairPathway	h_blymphocytePathway	h_ctlPathway	h_granulocytesPathway	h_lympathway	h_lymphocytePathway	h_monocytePathway	h_neutrophilPathway	h_tcytotoxicPathway	h_thelperPathway
ICAM2	h_granulocytesPathway	h_lympathway
ICOS	h_ctla4Pathway
ICOSLG	h_ctla4Pathway
IFNA1	h_cytokinePathway	h_dcPathway	h_ifnaPathway	h_il1rPathway	h_inflamPathway
IFNAR1	h_ifnaPathway	h_ranklPathway
IFNAR2	h_ifnaPathway	h_ranklPathway
IFNB1	h_cytokinePathway	h_dcPathway	h_ifnaPathway	h_il1rPathway	h_inflamPathway	h_ranklPathway
IFNG	h_41bbPathway	h_IL12Pathway	h_cytokinePathway	h_dcPathway	h_granulocytesPathway	h_ifngPathway	h_il18Pathway	h_inflamPathway	h_nktPathway	h_no2il12Pathway	h_th1th2Pathway	h_tidPathway	h_tob1Pathway
IFNGR1	h_ifngPathway	h_nktPathway	h_th1th2Pathway	h_tidPathway
IFNGR2	h_ifngPathway	h_nktPathway	h_th1th2Pathway	h_tidPathway
IGF1	h_badPathway	h_erythPathway	h_ghrelinPathway	h_hdacPathway	h_igf1Pathway	h_igf1mtorpathway	h_longevityPathway	h_nfatPathway
IGF1R	h_badPathway	h_erkPathway	h_hdacPathway	h_igf1Pathway	h_igf1mtorpathway	h_igf1rPathway	h_longevityPathway	h_telPathway
IGFALS	h_ghrelinPathway
IGFBP1	h_ghrelinPathway
IGFBP2	h_ghrelinPathway
IGFBP3	h_ghrelinPathway	h_p53hypoxiaPathway
IGFBP4	h_ghrelinPathway
IGFBP6	h_ghrelinPathway
IKBKAP	h_cd40Pathway	h_tnfr2Pathway
IKBKB	h_41bbPathway	h_cd40Pathway	h_il1rPathway	h_keratinocytePathway	h_mapkPathway	h_nfkbPathway	h_nthiPathway	h_stressPathway	h_tidPathway	h_tnfr2Pathway	h_tollPathway
IKBKG	h_cd40Pathway	h_nfkbPathway	h_stressPathway	h_tnfr2Pathway	h_tollPathway
IKZF3	h_il2rbPathway
IL10	h_asbcellPathway	h_cytokinePathway	h_dcPathway	h_il10Pathway	h_inflamPathway
IL10RA	h_il10Pathway	h_il22bppathway
IL11	h_erythPathway	h_inflamPathway	h_stemPathway
IL12A	h_IL12Pathway	h_cytokinePathway	h_dcPathway	h_il18Pathway	h_inflamPathway	h_nktPathway	h_no2il12Pathway	h_th1th2Pathway
IL12B	h_th1th2Pathway
IL12RB1	h_IL12Pathway	h_nktPathway	h_no2il12Pathway	h_th1th2Pathway
IL12RB2	h_IL12Pathway	h_nktPathway	h_no2il12Pathway	h_th1th2Pathway
IL13	h_GATA3pathway	h_cytokinePathway	h_dcPathway	h_inflamPathway
IL15	h_cytokinePathway	h_inflamPathway
IL16	h_cytokinePathway
IL17A	h_cytokinePathway	h_il17Pathway
IL18	h_IL12Pathway	h_cytokinePathway	h_il18Pathway	h_nkcellsPathway	h_th1th2Pathway
IL18R1	h_IL12Pathway	h_nktPathway	h_th1th2Pathway
IL1A	h_LairPathway	h_cytokinePathway	h_erythPathway	h_granulocytesPathway	h_hsp27Pathway	h_il10Pathway	h_il1rPathway	h_inflamPathway	h_lympathway	h_nfkbPathway
IL1B	h_il1rPathway	h_il5Pathway	h_mspPathway	h_nthiPathway
IL1R1	h_il1rPathway	h_nfkbPathway
IL1RAP	h_il1rPathway
IL1RN	h_il1rPathway
IL22	h_il22bppathway
IL22RA1	h_il22bppathway
IL22RA2	h_il22bppathway
IL2	h_41bbPathway	h_asbcellPathway	h_ctla4Pathway	h_cytokinePathway	h_il18Pathway	h_il2Pathway	h_inflamPathway	h_nktPathway	h_ox40Pathway	h_stemPathway	h_th1th2Pathway	h_tob1Pathway
IL2RA	h_il2Pathway	h_il2rbPathway	h_th1th2Pathway	h_tob1Pathway
IL2RB	h_il2Pathway	h_il2rbPathway
IL2RG	h_il2Pathway	h_il2rbPathway	h_il4Pathway	h_il7Pathway
IL3	h_badPathway	h_cytokinePathway	h_dcPathway	h_eosinophilsPathway	h_erythPathway	h_il17Pathway	h_il3Pathway	h_inflamPathway	h_stemPathway
IL3RA	h_badPathway	h_il3Pathway
IL4	h_41bbPathway	h_GATA3pathway	h_asbcellPathway	h_cytokinePathway	h_dcPathway	h_il4Pathway	h_il5Pathway	h_inflamPathway	h_nktPathway	h_stemPathway	h_th1th2Pathway	h_tob1Pathway
IL4R	h_il4Pathway	h_nktPathway	h_th1th2Pathway
IL5	h_GATA3pathway	h_cytokinePathway	h_dcPathway	h_eosinophilsPathway	h_il5Pathway	h_inflamPathway	h_nktPathway	h_stemPathway
IL5RA	h_il5Pathway
IL6	h_LDLpathway	h_LairPathway	h_cytokinePathway	h_erythPathway	h_her2Pathway	h_il10Pathway	h_il17Pathway	h_il1rPathway	h_il5Pathway	h_il6Pathway	h_inflamPathway	h_stemPathway
IL6R	h_her2Pathway	h_il6Pathway
IL6ST	h_her2Pathway	h_il6Pathway
IL7	h_il7Pathway	h_inflamPathway	h_stemPathway
IL7R	h_il7Pathway
IL8	h_LairPathway	h_cytokinePathway	h_freePathway	h_granulocytesPathway	h_il17Pathway	h_inflamPathway	h_lympathway	h_nthiPathway	h_pepiPathway	h_stemPathway
IL9	h_cytokinePathway	h_erythPathway	h_stemPathway
ILK	h_ptenPathway
INPPL1	h_igf1mtorpathway
INSR	h_ghPathway	h_hdacPathway	h_insulinPathway
IRAK1	h_gsk3Pathway	h_nfkbPathway	h_tollPathway
IRAK2	h_il1rPathway
IRF3	h_pcafpathway
IRF9	h_ifnaPathway	h_ranklPathway
IRS1	h_eif4Pathway	h_ghPathway	h_igf1Pathway	h_igf1rPathway	h_il2rbPathway	h_il4Pathway	h_insulinPathway
ITGA4	h_LairPathway	h_lympathway	h_lymphocytePathway	h_monocytePathway
ITGAL	h_LairPathway	h_blymphocytePathway	h_ctlPathway	h_granulocytesPathway	h_lympathway	h_lymphocytePathway	h_monocytePathway	h_neutrophilPathway	h_tcytotoxicPathway	h_thelperPathway
ITGAM	h_granulocytesPathway	h_monocytePathway	h_neutrophilPathway
ITGAV	h_edg1Pathway
ITGAX	h_dcPathway
ITGB1	h_LairPathway	h_agrPathway	h_bcellsurvivalPathway	h_ecmPathway	h_ephA4Pathway	h_erkPathway	h_integrinPathway	h_lympathway	h_lymphocytePathway	h_mCalpainPathway	h_metPathway	h_monocytePathway	h_nkcellsPathway	h_ptenPathway	h_sppaPathway	h_tffPathway	h_ucalpainPathway
ITGB2	h_LairPathway	h_blymphocytePathway	h_ctlPathway	h_granulocytesPathway	h_lympathway	h_lymphocytePathway	h_monocytePathway	h_neutrophilPathway	h_tcytotoxicPathway	h_thelperPathway
ITGB3	h_edg1Pathway	h_ucalpainPathway
ITK	h_ctla4Pathway
JAK1	h_egfPathway	h_ifnaPathway	h_ifngPathway	h_il10Pathway	h_il2Pathway	h_il2rbPathway	h_il4Pathway	h_il7Pathway	h_pdgfPathway
JAK2	h_IL12Pathway	h_TPOPathway	h_biopeptidesPathway	h_epoPathway	h_eponfkbPathway	h_ghPathway	h_gleevecpathway	h_ifngPathway	h_il3Pathway	h_no2il12Pathway	h_tidPathway
JAK3	h_il22bppathway	h_il2Pathway	h_il2rbPathway	h_il4Pathway	h_il6Pathway	h_il7Pathway	h_stat3Pathway
JTV1	h_eif2Pathway
JUNB	h_GATA3pathway
JUND	h_bcellsurvivalPathway	h_fosbPathway
JUN	h_41bbPathway	h_At1rPathway	h_Ccr5Pathway	h_IL12Pathway	h_TPOPathway	h_agrPathway	h_arenrf2Pathway	h_atmPathway	h_bcrPathway	h_cardiacegfPathway	h_cdMacPathway	h_d4gdiPathway	h_dreampathway	h_egfPathway	h_epoPathway	h_etsPathway	h_fasPathway	h_fcer1Pathway	h_gleevecpathway	h_gpcrPathway	h_hifPathway	h_igf1Pathway	h_il1rPathway	h_il2Pathway	h_il6Pathway	h_insulinPathway	h_integrinPathway	h_keratinocytePathway	h_mapkPathway	h_metPathway	h_ngfPathway	h_pcafpathway	h_pdgfPathway	h_pparaPathway	h_pyk2Pathway	h_stressPathway	h_tcrPathway	h_tnfr1Pathway	h_tollPathway	h_tsp1Pathway
KAT2B	h_pcafpathway	h_rarrxrPathway	h_vdrPathway
KAT5	h_pitx2Pathway
KCNA1	h_bArrestin-srcPathway	h_bArrestinPathway	h_barr-mapkPathway
KCNIP3	h_dreampathway
KCNQ4	h_raccPathway
KDELR1	h_arapPathway
KDR	h_no1Pathway	h_vegfPathway
KEAP1	h_arenrf2Pathway
KHDRBS1	h_sam68Pathway
KIF15	h_ranMSpathway
KIT	h_badPathway	h_melanocytepathway
KITLG	h_badPathway	h_erythPathway	h_il17Pathway	h_mcmPathway	h_melanocytepathway
KLRC1	h_nkcellsPathway
KLRD1	h_nkcellsPathway
KNG1	h_intrinsicPathway
KPNA2	h_npcPathway	h_ranMSpathway
KPNB1	h_npcPathway	h_ranMSpathway
KRAS	h_telPathway
KREMEN2	h_wnt-lrp6Pathway
L1CAM	h_ephA4Pathway
LAMA1	h_prionPathway
LAMA3	h_agrPathway
LAMB1	h_prionPathway
LAMC1	h_prionPathway
LAT	h_nkcellsPathway	h_tcrPathway
LBP	h_gsk3Pathway
LCK	h_CSKPathway	h_ctla4Pathway	h_il2Pathway	h_il7Pathway	h_tcrPathway	h_tcraPathway
LDB1	h_pitx2Pathway
LDHA	h_SARSpathway	h_hifPathway
LDLR	h_LDLpathway	h_fxrPathway	h_s1pPathway
LEF1	h_gsk3Pathway	h_pitx2Pathway
LEMD3	h_aMANpathway	h_eradPathway
LEP	h_leptinPathway
LEPR	h_leptinPathway
LFNG	h_hesPathway
LIF	h_nfatPathway
LIMK1	h_CCR3Pathway	h_malPathway	h_rac1Pathway	h_rhoPathway
LIN7A	h_tidPathway
LMNA	h_HivnefPathway	h_caspasePathway	h_deathPathway	h_fasPathway	h_tnfr1Pathway
LMNB1	h_HivnefPathway	h_caspasePathway	h_fasPathway	h_tnfr1Pathway
LMNB2	h_caspasePathway	h_fasPathway	h_tnfr1Pathway
LOC100128155	h_ptdinsPathway
LOC100129117	h_her2Pathway	h_tffPathway
LOC100130109	h_smPathway
LOC100130694	h_botulinPathway
LOC100131320	h_rabPathway
LOC100131484	h_RacCycDPathway	h_atmPathway	h_calcineurinPathway	h_cellcyclePathway	h_eponfkbPathway	h_g1Pathway	h_g2Pathway	h_p53Pathway	h_p53hypoxiaPathway
LOC100131490	h_dspPathway
LOC100132592	h_alkPathway
LOC100137724	h_deathPathway
LOC256021	h_btg2Pathway
LOC647001	h_glycolysisPathway	h_mta3Pathway
LOC728825	h_sumoPathway
LPAR1	h_akap13Pathway
LPL	h_LDLpathway	h_pparaPathway	h_ppargPathway	h_vobesityPathway
LRP6	h_wnt-lrp6Pathway
LRP8	h_Lis1Pathway	h_reelinPathway
LTA	h_cytokinePathway	h_inflamPathway	h_stressPathway	h_tnfr2Pathway
LY96	h_gsk3Pathway	h_tollPathway
LYN	h_bcrPathway	h_ephA4Pathway	h_fcer1Pathway	h_ptdinsPathway
MADCAM1	h_lympathway
MADD	h_tnfr1Pathway
MAFF	h_arenrf2Pathway
MAFG	h_arenrf2Pathway
MAF	h_GATA3pathway
MAFK	h_arenrf2Pathway
MAL	h_malPathway
MAN2A2	h_aMANpathway	h_eradPathway
MAP2	h_akapCentrosomePathway
MAP2K1	h_At1rPathway	h_CCR3Pathway	h_TPOPathway	h_anthraxPathway	h_bArrestin-srcPathway	h_barr-mapkPathway	h_bcrPathway	h_biopeptidesPathway	h_cdMacPathway	h_cdk5Pathway	h_ceramidePathway	h_cxcr4Pathway	h_ecmPathway	h_egfPathway	h_egfr_smrtePathway	h_epoPathway	h_erkPathway	h_fMLPpathway	h_fcer1Pathway	h_ghPathway	h_gleevecpathway	h_gpcrPathway	h_hcmvPathway	h_her2Pathway	h_igf1Pathway	h_igf1rPathway	h_il2Pathway	h_il3Pathway	h_il6Pathway	h_insulinPathway	h_integrinPathway	h_keratinocytePathway	h_malPathway	h_mapkPathway	h_metPathway	h_nfatPathway	h_ngfPathway	h_nkcellsPathway	h_pdgfPathway	h_pyk2Pathway	h_rasPathway	h_sppaPathway	h_spryPathway	h_tcrPathway	h_tgfbPathway
MAP2K2	h_At1rPathway	h_anthraxPathway	h_bArrestin-srcPathway	h_barr-mapkPathway	h_biopeptidesPathway	h_cdk5Pathway	h_erkPathway	h_fMLPpathway	h_hcmvPathway	h_integrinPathway	h_malPathway	h_mapkPathway	h_metPathway	h_pyk2Pathway
MAP2K3	h_GATA3pathway	h_fMLPpathway	h_hcmvPathway	h_il1rPathway	h_keratinocytePathway	h_mapkPathway	h_nthiPathway	h_pyk2Pathway	h_stressPathway	h_tollPathway
MAP2K4	h_At1rPathway	h_ceramidePathway	h_egfPathway	h_fasPathway	h_fcer1Pathway	h_gleevecpathway	h_keratinocytePathway	h_mapkPathway	h_p38mapkPathway	h_pdgfPathway	h_pyk2Pathway	h_stressPathway	h_tcrPathway	h_tnfr1Pathway	h_tollPathway
MAP2K5	h_mapkPathway
MAP2K6	h_IL12Pathway	h_fMLPpathway	h_hcmvPathway	h_hdacPathway	h_il1rPathway	h_keratinocytePathway	h_mapkPathway	h_nthiPathway	h_p38mapkPathway	h_stressPathway	h_tollPathway
MAP2K7	h_HivnefPathway	h_fcer1Pathway	h_keratinocytePathway	h_mapkPathway
MAP3K10	h_mapkPathway
MAP3K11	h_mapkPathway
MAP3K12	h_mapkPathway
MAP3K13	h_mapkPathway
MAP3K14	h_HivnefPathway	h_cd40Pathway	h_deathPathway	h_il1rPathway	h_keratinocytePathway	h_mapkPathway	h_nfkbPathway	h_nthiPathway	h_rnaPathway	h_stressPathway	h_tall1Pathway	h_tnfr2Pathway	h_tollPathway
MAP3K1	h_41bbPathway	h_At1rPathway	h_HivnefPathway	h_bcrPathway	h_cd40Pathway	h_ceramidePathway	h_egfPathway	h_egfr_smrtePathway	h_fMLPpathway	h_fasPathway	h_fcer1Pathway	h_gleevecpathway	h_hcmvPathway	h_il1rPathway	h_keratinocytePathway	h_malPathway	h_mapkPathway	h_nfkbPathway	h_p38mapkPathway	h_pdgfPathway	h_pyk2Pathway	h_rac1Pathway	h_stressPathway	h_tcrPathway	h_tnfr1Pathway	h_tnfr2Pathway	h_tollPathway	h_vipPathway
MAP3K2	h_mapkPathway
MAP3K3	h_mapkPathway
MAP3K4	h_mapkPathway
MAP3K5	h_41bbPathway	h_HivnefPathway	h_keratinocytePathway	h_mapkPathway	h_p38mapkPathway
MAP3K6	h_mapkPathway
MAP3K7	h_Par1Pathway	h_alkPathway	h_fasPathway	h_il1rPathway	h_mapkPathway	h_nfkbPathway	h_nthiPathway	h_p38mapkPathway	h_tgfbPathway	h_tnfr1Pathway	h_tollPathway	h_wntPathway
MAP3K7IP1	h_il1rPathway	h_nfkbPathway	h_tgfbPathway	h_tollPathway	h_wntPathway
MAP3K7IP2	h_tollPathway
MAP3K8	h_mapkPathway
MAP3K9	h_mapkPathway	h_p38mapkPathway
MAP4K1	h_mapkPathway	h_metPathway
MAP4K2	h_malPathway	h_mapkPathway	h_stressPathway
MAP4K3	h_mapkPathway
MAP4K4	h_mapkPathway
MAP4K5	h_41bbPathway	h_mapkPathway
MAPK10	h_mapkPathway
MAPK11	h_mapkPathway	h_nthiPathway
MAPK12	h_mapkPathway
MAPK13	h_keratinocytePathway	h_mapkPathway	h_stathminPathway
MAPK14	h_41bbPathway	h_Ccr5Pathway	h_GATA3pathway	h_IL12Pathway	h_SARSpathway	h_arenrf2Pathway	h_bcrPathway	h_biopeptidesPathway	h_crebPathway	h_dspPathway	h_egfr_smrtePathway	h_eif4Pathway	h_fMLPpathway	h_hcmvPathway	h_hdacPathway	h_il1rPathway	h_keratinocytePathway	h_mapkPathway	h_nfatPathway	h_nthiPathway	h_p38mapkPathway	h_pyk2Pathway	h_stressPathway	h_tall1Pathway	h_tollPathway	h_tsp1Pathway
MAPK1	h_At1rPathway	h_CCR3Pathway	h_RacCycDPathway	h_agrPathway	h_arenrf2Pathway	h_bArrestin-srcPathway	h_badPathway	h_barr-mapkPathway	h_biopeptidesPathway	h_cdMacPathway	h_cdk5Pathway	h_ceramidePathway	h_crebPathway	h_cxcr4Pathway	h_ecmPathway	h_edg1Pathway	h_eif4Pathway	h_erk5Pathway	h_erkPathway	h_fMLPpathway	h_fcer1Pathway	h_hcmvPathway	h_her2Pathway	h_igf1rPathway	h_integrinPathway	h_keratinocytePathway	h_malPathway	h_mapkPathway	h_metPathway	h_nfatPathway	h_pelp1Pathway	h_ptenPathway	h_pyk2Pathway	h_sam68Pathway	h_sppaPathway	h_spryPathway	h_tffPathway
MAPK3	h_At1rPathway	h_CCR3Pathway	h_RacCycDPathway	h_TPOPathway	h_agrPathway	h_bArrestin-srcPathway	h_badPathway	h_barr-mapkPathway	h_bcrPathway	h_biopeptidesPathway	h_cdMacPathway	h_cdk5Pathway	h_ceramidePathway	h_crebPathway	h_cxcr4Pathway	h_dreampathway	h_dspPathway	h_ecmPathway	h_edg1Pathway	h_egfPathway	h_eif4Pathway	h_epoPathway	h_erk5Pathway	h_erkPathway	h_fMLPpathway	h_fcer1Pathway	h_ghPathway	h_gleevecpathway	h_gpcrPathway	h_hcmvPathway	h_her2Pathway	h_igf1Pathway	h_igf1rPathway	h_il2Pathway	h_il2rbPathway	h_il3Pathway	h_il6Pathway	h_insulinPathway	h_integrinPathway	h_keratinocytePathway	h_mPRPathway	h_malPathway	h_mapkPathway	h_metPathway	h_nfatPathway	h_ngfPathway	h_nkcellsPathway	h_pdgfPathway	h_pelp1Pathway	h_pparaPathway	h_ptenPathway	h_pyk2Pathway	h_rasPathway	h_sam68Pathway	h_sppaPathway	h_spryPathway	h_stat3Pathway	h_tcrPathway	h_tffPathway	h_tgfbPathway
MAPK4	h_mapkPathway
MAPK6	h_mapkPathway
MAPK7	h_erk5Pathway	h_hdacPathway	h_mapkPathway
MAPK8	h_41bbPathway	h_At1rPathway	h_Ccr5Pathway	h_HivnefPathway	h_IL12Pathway	h_agrPathway	h_arenrf2Pathway	h_atmPathway	h_bcrPathway	h_biopeptidesPathway	h_ceramidePathway	h_dspPathway	h_egfPathway	h_epoPathway	h_fasPathway	h_fcer1Pathway	h_gleevecpathway	h_igf1Pathway	h_il1rPathway	h_il2Pathway	h_insulinPathway	h_integrinPathway	h_keratinocytePathway	h_malPathway	h_mapkPathway	h_metPathway	h_nfatPathway	h_ngfPathway	h_p53hypoxiaPathway	h_pdgfPathway	h_pyk2Pathway	h_ranklPathway	h_stressPathway	h_tall1Pathway	h_tcrPathway	h_tnfr1Pathway	h_tollPathway
MAPK9	h_mapkPathway
MAPKAPK2	h_hsp27Pathway	h_mapkPathway	h_p38mapkPathway
MAPKAPK3	h_hsp27Pathway	h_mapkPathway
MAPKAPK5	h_mapkPathway	h_p38mapkPathway
MAPT	h_biopeptidesPathway	h_p35alzheimersPathway
MARCKS	h_calcineurinPathway
MASP1	h_compPathway	h_lectinPathway
MASP2	h_compPathway	h_lectinPathway
MATR3	h_antisensePathway
MAX	h_mapkPathway	h_p38mapkPathway	h_tertpathway
MBD3	h_mta3Pathway
MBL2	h_compPathway	h_lectinPathway
MBTPS1	h_s1pPathway
MBTPS2	h_s1pPathway
MCM5	h_mcmPathway
MDH1	h_malatePathway	h_malatexPathway
MDM2	h_HivnefPathway	h_arfPathway	h_atmPathway	h_ctcfPathway	h_g2Pathway	h_p53Pathway	h_p53hypoxiaPathway	h_ranbp2Pathway
ME1	h_malatexPathway	h_pparaPathway
MED1	h_carm-erPathway	h_pitx2Pathway	h_pparaPathway	h_ppargPathway	h_vdrPathway
MEF2A	h_At1rPathway	h_MITRPathway	h_erk5Pathway	h_hdacPathway	h_mapkPathway	h_p38mapkPathway	h_pgc1aPathway
MEF2C	h_alkPathway	h_carm-erPathway	h_nfatPathway
MEF2D	h_mef2dPathway
MET	h_cblPathway	h_metPathway
MITF	h_melanocytepathway
MKNK1	h_eif4Pathway	h_erkPathway	h_mTORPathway	h_mapkPathway	h_p38mapkPathway
MKNK2	h_erkPathway	h_mapkPathway
MLXIPL	h_chrebpPathway
MMP14	h_reckPathway
MMP2	h_reckPathway
MMP9	h_reckPathway
MPL	h_TPOPathway
MRE11A	h_atmPathway	h_atrbrcaPathway
MRPL11	h_pparaPathway
MS4A2	h_fcer1Pathway
MST075	h_p53hypoxiaPathway
MST1	h_mspPathway
MST1R	h_mspPathway
MTA1	h_mta3Pathway
MTA3	h_mta3Pathway
MUC2	h_tffPathway
MUSK	h_achPathway	h_agrPathway
MUT	h_methioninepathway
MYC	h_arfPathway	h_cardiacegfPathway	h_cdMacPathway	h_ctcfPathway	h_erkPathway	h_gleevecpathway	h_il2rbPathway	h_mapkPathway	h_p38mapkPathway	h_pparaPathway	h_telPathway	h_tertpathway	h_vipPathway	h_wntPathway
MYD88	h_gsk3Pathway	h_il1rPathway	h_nfkbPathway	h_nthiPathway	h_tollPathway
MYH2	h_nfatPathway
MYL2	h_CCR3Pathway	h_alkPathway	h_ecmPathway	h_mCalpainPathway	h_myosinPathway	h_rac1Pathway	h_rhoPathway
MYLK	h_biopeptidesPathway	h_ecmPathway	h_mCalpainPathway	h_myosinPathway	h_rac1Pathway	h_rhoPathway
MYOD1	h_MITRPathway	h_hdacPathway
MYT1	h_cdc25Pathway	h_g2Pathway	h_mPRPathway	h_rbPathway
MZF1	h_tertpathway
NBN	h_atmPathway	h_atrbrcaPathway
NCAM1	h_PDZsPathway
NCAPD2	h_akap95Pathway
NCF2	h_fMLPpathway	h_rac1Pathway
NCK1	h_actinYPathway
NCKAP1	h_actinYPathway
NCL	h_SARSpathway
NCOA2	h_ppargPathway	h_rarrxrPathway	h_vdrPathway
NCOR1	h_pparaPathway	h_vdrPathway
NCOR2	h_carm-erPathway	h_egfr_smrtePathway	h_etsPathway	h_pparaPathway	h_rarrxrPathway
NDEL1	h_Lis1Pathway
NDUFA1	h_etcPathway
NEDD8	h_p27Pathway
NF1	h_hSWI-SNFpathway
NFASC	h_PDZsPathway
NFATC1	h_GATA3pathway	h_bcrPathway	h_calcineurinPathway	h_fMLPpathway	h_fcer1Pathway	h_gpcrPathway	h_hdacPathway	h_mef2dPathway	h_nfatPathway	h_tcrPathway	h_vipPathway
NFE2L2	h_arenrf2Pathway	h_prionPathway
NFKB1	h_41bbPathway	h_HivnefPathway	h_RELAPathway	h_RacCycDPathway	h_aktPathway	h_atmPathway	h_cardiacegfPathway	h_cd40Pathway	h_cdMacPathway	h_ceramidePathway	h_cxcr4Pathway	h_deathPathway	h_eponfkbPathway	h_fMLPpathway	h_freePathway	h_gcrPathway	h_gsk3Pathway	h_hcmvPathway	h_il1rPathway	h_keratinocytePathway	h_mapkPathway	h_nfkbPathway	h_nthiPathway	h_pcafpathway	h_pkcPathway	h_ranklPathway	h_rasPathway	h_rnaPathway	h_stressPathway	h_tall1Pathway	h_tcrPathway	h_tidPathway	h_tnfr2Pathway	h_tollPathway	h_vipPathway
NFKBIA	h_41bbPathway	h_HivnefPathway	h_RELAPathway	h_RacCycDPathway	h_aktPathway	h_atmPathway	h_cd40Pathway	h_cdMacPathway	h_deathPathway	h_eponfkbPathway	h_fMLPpathway	h_il1rPathway	h_keratinocytePathway	h_mapkPathway	h_nfkbPathway	h_nthiPathway	h_pkcPathway	h_pparaPathway	h_rnaPathway	h_stressPathway	h_tcrPathway	h_tidPathway	h_tnfr2Pathway	h_tollPathway	h_vipPathway
NFKBIB	h_p53hypoxiaPathway
NFYA	h_tercPathway
NFYB	h_tercPathway
NFYC	h_tercPathway
NGF	h_btg2Pathway	h_cdk5Pathway	h_erkPathway	h_ngfPathway	h_trkaPathway
NGFR	h_cdk5Pathway	h_erkPathway	h_ngfPathway
NKX2-5	h_alkPathway	h_hopPathway	h_nfatPathway
NLK	h_wntPathway
NME2	h_ndkDynaminPathway	h_setPathway
NMI	h_il2rbPathway	h_il7Pathway
NOG	h_alkPathway
NONO	h_antisensePathway
NOS1	h_ctbp1Pathway	h_nos1Pathway
NOS2A	h_no2il12Pathway	h_pparaPathway
NOS3	h_gcrPathway	h_hifPathway	h_no1Pathway	h_raccPathway	h_vegfPathway
NOTCH1	h_hesPathway	h_notchpathway	h_ps1Pathway
NOTCH2	h_hesPathway
NOX1	h_CCR3Pathway	h_freePathway
NPAT	h_atmPathway	h_atrbrcaPathway	h_cdc25Pathway	h_chemicalPathway	h_g1Pathway	h_g2Pathway	h_p53Pathway	h_p53hypoxiaPathway	h_plk3Pathway	h_rbPathway
NPPA	h_alkPathway	h_gcrPathway	h_nfatPathway
NPPB	h_alkPathway
NQO1	h_p53hypoxiaPathway
NR0B1	h_carm-erPathway
NR0B2	h_pparaPathway
NR1H3	h_fxrPathway	h_nuclearRsPathway	h_pparaPathway
NR1H4	h_fxrPathway	h_nuclearRsPathway
NR1I2	h_nuclearRsPathway
NR1I3	h_AcetaminophenPathway	h_nuclearRsPathway
NR2F1	h_pparaPathway
NR3C1	h_gcrPathway	h_hSWI-SNFpathway	h_nthiPathway	h_vobesityPathway
NRG1	h_ErbB3Pathway
NRG2	h_agrPathway	h_erbB4pathway
NRG3	h_erbB4pathway
NRIP1	h_carm-erPathway	h_pparaPathway
NRXN3	h_PDZsPathway
NSF	h_gabaPathway
NSMAF	h_ceramidePathway
NTRK1	h_actinYPathway	h_erk5Pathway	h_trkaPathway
NUMA1	h_HivnefPathway	h_ranMSpathway
NUP153	h_npcPathway
NUP210	h_npcPathway
NUP62	h_npcPathway
NUTF2	h_npcPathway
OAT	h_argininecPathway
OPHN1	h_rhoPathway
OPRK1	h_dreampathway
ORC4L	h_mcmPathway
P2RY2	h_ionPathway
P4HB	h_hifPathway	h_vitCBPathway
PABPC1	h_eif4Pathway
PABPN1	h_cpsfPathway
PAK1	h_At1rPathway	h_RacCycDPathway	h_agrPathway	h_cdc42racPathway	h_fMLPpathway	h_fasPathway	h_mapkPathway	h_metPathway	h_nkcellsPathway	h_pyk2Pathway	h_rac1Pathway	h_tnfr1Pathway
PAK2	h_HivnefPathway	h_fasPathway	h_fcer1Pathway	h_mapkPathway	h_tnfr1Pathway
PAPOLA	h_cpsfPathway
PAQR5	h_mPRPathway
PARK2	h_ParkinsonsPathway	h_parkinPathway
PARP1	h_HivnefPathway	h_aifPathway	h_caspasePathway	h_chemicalPathway	h_d4gdiPathway	h_fasPathway	h_tnfr1Pathway
PAX3	h_pmlPathway
PC	h_malatexPathway
PCLO	h_PDZsPathway
PCNA	h_p53Pathway
PCNT	h_akapCentrosomePathway
PDE2A	h_no1Pathway
PDE6A	h_rhodopsinPathway
PDE6B	h_rhodopsinPathway
PDE6G	h_rhodopsinPathway
PDGFB	h_dbpbPathway
PDGFRA	h_cblPathway	h_cdc42racPathway	h_edg1Pathway	h_erkPathway	h_pdgfPathway	h_rac1Pathway
PDHA1	h_malatexPathway
PDK2	h_eif4Pathway	h_igf1mtorpathway	h_mTORPathway	h_ptenPathway
PDPK1	h_aktPathway	h_eif4Pathway	h_gsk3Pathway	h_igf1mtorpathway	h_mTORPathway	h_ptdinsPathway	h_ptenPathway
PDZK1	h_mta3Pathway
PEBP1	h_il1rPathway
PECAM1	h_cell2cellPathway	h_granulocytesPathway	h_lympathway	h_lymphocytePathway	h_monocytePathway	h_neutrophilPathway
PELP1	h_carm-erPathway	h_pelp1Pathway
PER1	h_circadianPathway
PFKL	h_glycolysisPathway
PFKM	h_ptdinsPathway
PFN1	h_ecmPathway	h_rhoPathway
PGDS	h_eicosanoidPathway
PGLYRP1	h_tollPathway
PGR	h_mPRPathway
PHB2	h_carm-erPathway
PHC1	h_prc2Pathway
PIAS1	h_ranbp2Pathway
PIAS2	h_ranbp2Pathway
PIK3C2G	h_CCR3Pathway	h_cxcr4Pathway	h_fMLPpathway
PIK3CA	h_RacCycDPathway	h_aktPathway	h_cdc42racPathway	h_crebPathway	h_ctla4Pathway	h_cxcr4Pathway	h_egfPathway	h_eif4Pathway	h_gsk3Pathway	h_igf1mtorpathway	h_igf1rPathway	h_mTORPathway	h_nkcellsPathway	h_ptenPathway	h_trkaPathway
PIK3CB	h_Par1Pathway	h_TPOPathway	h_achPathway	h_aktPathway	h_arfPathway	h_badPathway	h_bcellsurvivalPathway	h_ctcfPathway	h_ecmPathway	h_edg1Pathway	h_erk5Pathway	h_fcer1Pathway	h_gcrPathway	h_ghPathway	h_gleevecpathway	h_hcmvPathway	h_hdacPathway	h_her2Pathway	h_igf1Pathway	h_il2rbPathway	h_il7Pathway	h_insulinPathway	h_longevityPathway	h_metPathway	h_nfatPathway	h_ngfPathway	h_pdgfPathway	h_plcPathway	h_pparaPathway	h_rac1Pathway	h_rasPathway	h_tcrPathway	h_tffPathway	h_vegfPathway
PIK3R1	h_RacCycDPathway	h_aktPathway	h_cdc42racPathway	h_crebPathway	h_ctla4Pathway	h_cxcr4Pathway	h_egfPathway	h_eif4Pathway	h_gsk3Pathway	h_igf1mtorpathway	h_igf1rPathway	h_mTORPathway	h_nkcellsPathway	h_ptenPathway	h_trkaPathway
PIN1	h_mPRPathway
PIP5K1B	h_rhoPathway
PIR	h_actinYPathway
PITX2	h_pitx2Pathway
PKLR	h_glycolysisPathway
PKN1	h_akapCentrosomePathway	h_myosinPathway
PLA2G4A	h_eicosanoidPathway	h_fcer1Pathway	h_p38mapkPathway	h_sppaPathway
PLAT	h_amiPathway	h_fibrinolysisPathway	h_plateletAppPathway
PLAU	h_fibrinolysisPathway	h_plateletAppPathway
PLCB1	h_CCR3Pathway	h_Par1Pathway	h_bArrestin-srcPathway	h_bArrestinPathway	h_barr-mapkPathway	h_cdMacPathway	h_ck1Pathway	h_edg1Pathway	h_eicosanoidPathway	h_fMLPpathway	h_myosinPathway	h_pkcPathway	h_plcPathway	h_sppaPathway	h_tubbyPathway
PLCD1	h_plcdPathway
PLCE1	h_plcePathway
PLCG1	h_Ccr5Pathway	h_TPOPathway	h_bcrPathway	h_biopeptidesPathway	h_calcineurinPathway	h_cardiacegfPathway	h_cxcr4Pathway	h_egfPathway	h_epoPathway	h_erk5Pathway	h_fcer1Pathway	h_ghPathway	h_gpcrPathway	h_ionPathway	h_ngfPathway	h_pdgfPathway	h_plcPathway	h_ptdinsPathway	h_pyk2Pathway	h_tcrPathway	h_trkaPathway	h_vegfPathway	h_vipPathway
PLD1	h_cb1rPathway	h_rac1Pathway	h_rasPathway
PLD2	h_cb1rPathway
PLD3	h_cb1rPathway
PLG	h_amiPathway	h_fibrinolysisPathway	h_plateletAppPathway
PLK1	h_g2Pathway
PLK3	h_plk3Pathway
PML	h_pmlPathway
POLR1A	h_arfPathway
POLR2A	h_carm-erPathway	h_dreampathway	h_hSWI-SNFpathway	h_pcafpathway	h_rarrxrPathway	h_telPathway
POR	h_arenrf2Pathway
PPARA	h_bArrestinPathway	h_nuclearRsPathway	h_pgc1aPathway	h_pparPathway	h_pparaPathway	h_tollPathway
PPARD	h_nuclearRsPathway	h_pparPathway	h_wntPathway
PPARGC1A	h_carm-erPathway	h_pgc1aPathway	h_pparaPathway	h_ppargPathway
PPARG	h_nuclearRsPathway	h_pparPathway	h_ppargPathway	h_vobesityPathway
PPIA	h_il2rbPathway
PPP1CA	h_akap95Pathway	h_akapCentrosomePathway	h_ck1Pathway	h_eif2Pathway
PPP1R12B	h_CCR3Pathway	h_Par1Pathway	h_integrinPathway	h_myosinPathway	h_rac1Pathway	h_rhoPathway
PPP1R1B	h_ck1Pathway	h_fosbPathway
PPP2CA	h_akap95Pathway	h_akapCentrosomePathway	h_aktPathway	h_chrebpPathway	h_ck1Pathway	h_ctcfPathway	h_erkPathway	h_gsk3Pathway	h_igf1mtorpathway	h_keratinocytePathway	h_mTORPathway	h_p35alzheimersPathway	h_telPathway	h_wntPathway
PPP3CA	h_bcrPathway	h_calcineurinPathway	h_ck1Pathway	h_fMLPpathway	h_fcer1Pathway	h_gpcrPathway	h_hdacPathway	h_mef2dPathway	h_ndkDynaminPathway	h_nfatPathway	h_nos1Pathway	h_pgc1aPathway	h_tcrPathway	h_vipPathway
PRF1	h_caspasePathway	h_ctlPathway	h_d4gdiPathway	h_setPathway
PRKAA1	h_chrebpPathway	h_leptinPathway
PRKACA	h_akap13Pathway	h_akap95Pathway	h_akapCentrosomePathway	h_gsPathway
PRKAR1A	h_gsPathway
PRKAR1B	h_CSKPathway	h_GATA3pathway	h_agpcrPathway	h_badPathway	h_carm1Pathway	h_cftrPathway	h_chrebpPathway	h_ck1Pathway	h_crebPathway	h_dreampathway	h_gpcrPathway	h_igf1rPathway	h_mCalpainPathway	h_mPRPathway	h_nfatPathway	h_no1Pathway	h_nos1Pathway	h_plcePathway	h_pparaPathway	h_shhPathway	h_stathminPathway	h_vipPathway
PRKAR2A	h_akap13Pathway	h_akap95Pathway	h_akapCentrosomePathway
PRKAR2B	h_akap13Pathway	h_akap95Pathway	h_akapCentrosomePathway
PRKCA	h_At1rPathway	h_CCR3Pathway	h_Ccr5Pathway	h_Par1Pathway	h_TPOPathway	h_agpcrPathway	h_arenrf2Pathway	h_bcrPathway	h_biopeptidesPathway	h_calcineurinPathway	h_cardiacegfPathway	h_cblPathway	h_cdMacPathway	h_chemicalPathway	h_crebPathway	h_cxcr4Pathway	h_edg1Pathway	h_egfPathway	h_eif4Pathway	h_erbB4pathway	h_ghPathway	h_gpcrPathway	h_ionPathway	h_keratinocytePathway	h_mef2dPathway	h_myosinPathway	h_nos1Pathway	h_pdgfPathway	h_pkcPathway	h_plcPathway	h_plcdPathway	h_pparaPathway	h_pyk2Pathway	h_sppaPathway	h_srcRPTPPathway	h_tcrPathway	h_telPathway	h_trkaPathway	h_vegfPathway
PRKCB	h_biopeptidesPathway	h_fcer1Pathway	h_ionPathway	h_tcrPathway
PRKCD	h_HivnefPathway
PRKCE	h_akapCentrosomePathway	h_flumazenilPathway	h_ptdinsPathway
PRKCQ	h_keratinocytePathway
PRKCZ	h_ptdinsPathway
PRKDC	h_HivnefPathway	h_fasPathway	h_g2Pathway	h_tnfr1Pathway
PRKG2	h_no1Pathway	h_raccPathway
PRMT1	h_btg2Pathway	h_vdrPathway
PRNP	h_prionPathway
PROC	h_amiPathway	h_extrinsicPathway	h_intrinsicPathway
PROCR	h_dbpbPathway
PRODH	h_argininecPathway
PROS1	h_amiPathway	h_extrinsicPathway	h_intrinsicPathway
PSEN1	h_HivnefPathway	h_appPathway	h_erbB4pathway	h_notchpathway	h_ps1Pathway
PSMA7	h_actinYPathway
PSMB5	h_mhcPathway
PTBP1	h_iresPathway
PTCH1	h_ptc1Pathway	h_shhPathway
PTEN	h_ctcfPathway	h_eif4Pathway	h_igf1mtorpathway	h_mTORPathway	h_metPathway	h_ptenPathway
PTGER1	h_eicosanoidPathway	h_plcePathway
PTGER2	h_eicosanoidPathway
PTGER3	h_eicosanoidPathway
PTGER4	h_eicosanoidPathway
PTGES	h_eicosanoidPathway
PTGFR	h_eicosanoidPathway
PTGIR	h_eicosanoidPathway
PTGIS	h_eicosanoidPathway
PTGS1	h_AcetaminophenPathway	h_eicosanoidPathway	h_sppaPathway
PTGS2	h_AcetaminophenPathway	h_eicosanoidPathway
PTK2B	h_At1rPathway	h_Ccr5Pathway	h_HBxPathway	h_Par1Pathway	h_achPathway	h_biopeptidesPathway	h_cxcr4Pathway	h_il7Pathway	h_ionPathway	h_metPathway	h_nkcellsPathway	h_pyk2Pathway
PTK2	h_At1rPathway	h_CCR3Pathway	h_HivnefPathway	h_achPathway	h_agrPathway	h_cell2cellPathway	h_chemicalPathway	h_cxcr4Pathway	h_ecmPathway	h_edg1Pathway	h_integrinPathway	h_mCalpainPathway	h_metPathway	h_ptenPathway	h_sppaPathway	h_tffPathway	h_ucalpainPathway	h_vegfPathway
PTPN13	h_fasPathway
PTPN6	h_epoPathway	h_ghPathway	h_il2rbPathway	h_il3Pathway	h_nkcellsPathway
PTPN7	h_tcrPathway
PTPRA	h_srcRPTPPathway
PTPRB	h_spryPathway
PTPRC	h_CSKPathway	h_blymphocytePathway	h_tcraPathway	h_tcytotoxicPathway	h_thelperPathway
PTPRR	h_erkPathway
PVRL1	h_th1th2Pathway
PXN	h_agrPathway	h_cell2cellPathway	h_chemicalPathway	h_cxcr4Pathway	h_ecmPathway	h_integrinPathway	h_mCalpainPathway	h_metPathway	h_ucalpainPathway	h_vegfPathway
RAB11A	h_rabPathway
RAB1A	h_rabPathway
RAB27A	h_rabPathway
RAB2A	h_rabPathway
RAB3A	h_rabPathway
RAB4A	h_rabPathway
RAB5A	h_eea1Pathway	h_ptdinsPathway	h_rabPathway
RAB7A	h_rabPathway
RAB8A	h_rabPathway
RAB9A	h_rabPathway
RAC1	h_At1rPathway	h_RacCycDPathway	h_actinYPathway	h_agrPathway	h_arfPathway	h_bcrPathway	h_cdc42racPathway	h_crebPathway	h_edg1Pathway	h_fMLPpathway	h_malPathway	h_mapkPathway	h_nkcellsPathway	h_p38mapkPathway	h_ptdinsPathway	h_pyk2Pathway	h_rac1Pathway	h_rasPathway	h_salmonellaPathway	h_tcrPathway	h_ucalpainPathway
RAD17	h_atrbrcaPathway
RAD1	h_atrbrcaPathway
RAD50	h_atmPathway	h_atrbrcaPathway
RAD51	h_atmPathway	h_atrbrcaPathway
RAD9A	h_atrbrcaPathway
RAF1	h_At1rPathway	h_CCR3Pathway	h_RacCycDPathway	h_TPOPathway	h_bArrestin-srcPathway	h_barr-mapkPathway	h_bcrPathway	h_biopeptidesPathway	h_cdMacPathway	h_cdk5Pathway	h_ceramidePathway	h_cxcr4Pathway	h_ecmPathway	h_egfPathway	h_epoPathway	h_erkPathway	h_fMLPpathway	h_fcer1Pathway	h_ghPathway	h_gleevecpathway	h_gpcrPathway	h_her2Pathway	h_igf1Pathway	h_igf1rPathway	h_il2Pathway	h_il2rbPathway	h_il3Pathway	h_il6Pathway	h_insulinPathway	h_integrinPathway	h_keratinocytePathway	h_malPathway	h_mapkPathway	h_metPathway	h_nfatPathway	h_ngfPathway	h_pdgfPathway	h_pyk2Pathway	h_rasPathway	h_sppaPathway	h_spryPathway	h_tcrPathway
RALA	h_rasPathway
RALBP1	h_rac1Pathway	h_rasPathway
RALGDS	h_rasPathway
RANBP1	h_ranMSpathway	h_ranPathway
RANBP2	h_npcPathway	h_ranPathway	h_ranbp2Pathway
RANGAP1	h_npcPathway	h_ranMSpathway	h_ranPathway	h_ranbp2Pathway
RAN	h_npcPathway	h_ranMSpathway	h_ranPathway	h_ranbp2Pathway
RAP1A	h_integrinPathway	h_metPathway
RAP1B	h_ephA4Pathway	h_metPathway
RAP2B	h_plcePathway
RAPGEF1	h_integrinPathway	h_metPathway
RAPGEF2	h_mapkPathway	h_p38mapkPathway
RAPGEF5	h_ghrelinPathway
RAPSN	h_achPathway	h_agrPathway
RARA	h_carm1Pathway	h_egfr_smrtePathway	h_nuclearRsPathway	h_pmlPathway	h_rarPathway	h_rarrxrPathway
RARB	h_nuclearRsPathway
RARG	h_nuclearRsPathway
RASA1	h_HivnefPathway	h_TPOPathway	h_egfPathway	h_igf1Pathway	h_insulinPathway	h_metPathway	h_pdgfPathway	h_sam68Pathway	h_spryPathway	h_tcrPathway
RASGRF1	h_cdc25Pathway	h_g2Pathway	h_ptc1Pathway	h_rbPathway	h_srcRPTPPathway
RB1CC1	h_stathminPathway
RB1	h_HivnefPathway	h_RacCycDPathway	h_arfPathway	h_btg2Pathway	h_cellcyclePathway	h_fasPathway	h_fbw7Pathway	h_g1Pathway	h_hcmvPathway	h_p27Pathway	h_p53Pathway	h_pmlPathway	h_pparaPathway	h_rbPathway	h_skp2e2fPathway	h_telPathway	h_tercPathway	h_tidPathway	h_tnfr1Pathway
RBBP4	h_prc2Pathway
RBBP7	h_prc2Pathway
RBBP8	h_atmPathway
RBL1	h_cellcyclePathway	h_etsPathway
RBL2	h_etsPathway
RBPJ	h_hesPathway	h_notchpathway	h_ps1Pathway
RBX1	h_eradPathway	h_p27Pathway
RCC1	h_npcPathway	h_ranMSpathway	h_ranPathway
RCVRN	h_rhodopsinPathway
RECK	h_reckPathway
RELA	h_RELAPathway	h_RacCycDPathway	h_eponfkbPathway	h_nfkbPathway	h_nthiPathway	h_pparaPathway
REN	h_ace2Pathway
RETN	h_vobesityPathway
RHEB	h_mTORPathway
RHOA	h_CCR3Pathway	h_Par1Pathway	h_RacCycDPathway	h_akap13Pathway	h_akapCentrosomePathway	h_cardiacegfPathway	h_cdc42racPathway	h_ecmPathway	h_edg1Pathway	h_integrinPathway	h_malPathway	h_rasPathway	h_rhoPathway	h_tffPathway	h_ucalpainPathway
RHO	h_rhodopsinPathway
RING1	h_prc2Pathway
RIPK1	h_HivnefPathway	h_RELAPathway	h_ceramidePathway	h_deathPathway	h_keratinocytePathway	h_mapkPathway	h_nfkbPathway	h_p38mapkPathway	h_soddPathway	h_stressPathway	h_tnfr1Pathway	h_tnfr2Pathway
RIPK2	h_fasPathway
RLN3	h_carm-erPathway
ROCK1	h_Par1Pathway	h_ecmPathway	h_integrinPathway	h_malPathway	h_myosinPathway	h_rhoPathway
ROCK2	h_CCR3Pathway
RPA1	h_p53hypoxiaPathway
RPS6	h_igf1mtorpathway	h_mTORPathway
RPS6KA1	h_badPathway	h_crebPathway	h_erk5Pathway	h_erkPathway	h_g2Pathway	h_ghPathway	h_igf1rPathway	h_mPRPathway	h_mapkPathway	h_melanocytepathway
RPS6KA2	h_mapkPathway
RPS6KA3	h_gpcrPathway	h_mapkPathway
RPS6KA4	h_mapkPathway
RPS6KA5	h_crebPathway	h_erkPathway	h_mapkPathway	h_p38mapkPathway
RPS6KB1	h_ctcfPathway	h_eif4Pathway	h_igf1mtorpathway	h_il2rbPathway	h_il4Pathway	h_mTORPathway	h_mapkPathway	h_nfatPathway	h_ptdinsPathway	h_rac1Pathway
RPS6KB2	h_mapkPathway
RPSA	h_prionPathway
RXRA	h_carm1Pathway	h_egfr_smrtePathway	h_fxrPathway	h_pparPathway	h_pparaPathway	h_ppargPathway	h_rarPathway	h_rarrxrPathway	h_vdrPathway	h_vobesityPathway
RYR2	h_no1Pathway
S1PR1	h_edg1Pathway
SAE1	h_ctbp1Pathway	h_eradPathway	h_sumoPathway
SAG	h_rhodopsinPathway
SCAP	h_s1pPathway
SCN2A	h_ahspPathway
SDHD	h_etcPathway
SEC61A1	h_eradPathway
SELE	h_lymphocytePathway	h_monocytePathway	h_neutrophilPathway
SELP	h_LairPathway	h_ephA4Pathway	h_granulocytesPathway	h_monocytePathway
SELPLG	h_LairPathway	h_granulocytesPathway
SEPT5	h_parkinPathway
SERPINB2	h_fibrinolysisPathway
SERPINC1	h_amiPathway	h_extrinsicPathway	h_intrinsicPathway
SERPINE1	h_fibrinolysisPathway	h_plateletAppPathway
SERPING1	h_intrinsicPathway
SET	h_setPathway
SFN	h_EfpPathway
SFPQ	h_antisensePathway
SFRS2	h_smPathway
SGCB	h_raccPathway
SH3KBP1	h_cblPathway
SHC1	h_At1rPathway	h_HBxPathway	h_TPOPathway	h_bcrPathway	h_biopeptidesPathway	h_ecmPathway	h_egfPathway	h_epoPathway	h_erk5Pathway	h_erkPathway	h_fcer1Pathway	h_ghPathway	h_her2Pathway	h_igf1Pathway	h_igf1rPathway	h_il2Pathway	h_il2rbPathway	h_il3Pathway	h_il4Pathway	h_il6Pathway	h_insulinPathway	h_integrinPathway	h_longevityPathway	h_mapkPathway	h_ngfPathway	h_p38mapkPathway	h_pdgfPathway	h_ptenPathway	h_pyk2Pathway	h_spryPathway	h_tcrPathway	h_tffPathway	h_trkaPathway	h_vegfPathway
SHH	h_ptc1Pathway	h_shhPathway
SIN3A	h_etsPathway
SIRT1	h_pmlPathway
SKIL	h_tgfbPathway
SKP1	h_eradPathway	h_fbw7Pathway	h_p27Pathway	h_skp2e2fPathway
SKP2	h_g1Pathway	h_p27Pathway	h_skp2e2fPathway
SLC1A3	h_malatePathway
SLC23A1	h_vitCBPathway
SLC23A2	h_vitCBPathway
SLC25A11	h_malatePathway	h_malatexPathway
SLC25A18	h_rhodopsinPathway
SLC25A1	h_malatexPathway
SLC25A20	h_cptPathway
SLC25A22	h_rhodopsinPathway
SLC25A4	h_etcPathway
SLC2A1	h_vitCBPathway
SLC2A4	h_ghPathway	h_insulinPathway	h_pgc1aPathway
SLC7A1	h_no1Pathway
SLC9A3R1	h_cftrPathway
SLPI	h_pepiPathway
SMAD1	h_alkPathway	h_ctcfPathway
SMAD2	h_tgfbPathway
SMAD3	h_g1Pathway	h_nthiPathway	h_tgfbPathway	h_tob1Pathway
SMAD4	h_alkPathway	h_ctcfPathway	h_g1Pathway	h_nthiPathway	h_tgfbPathway	h_tob1Pathway	h_wntPathway
SMAD5	h_alkPathway	h_ctcfPathway
SMAD6	h_alkPathway
SMAD7	h_tgfbPathway
SMARCA4	h_hSWI-SNFpathway	h_vdrPathway
SMARCB1	h_hSWI-SNFpathway
SMARCC1	h_hSWI-SNFpathway	h_vdrPathway
SMARCD1	h_hSWI-SNFpathway	h_vdrPathway
SMARCE1	h_hSWI-SNFpathway	h_vdrPathway
SMO	h_shhPathway
SMPD1	h_ceramidePathway
SMPD2	h_edg1Pathway
SMURF1	h_EfpPathway
SNAI1	h_mta3Pathway
SNCA	h_ParkinsonsPathway	h_parkinPathway
SNCAIP	h_parkinPathway
SNORA48	h_eif4Pathway	h_iresPathway	h_mTORPathway
SNRP70	h_smPathway
SNRPA1	h_smPathway
SNRPA	h_smPathway
SNRPB2	h_smPathway
SNRPB	h_smPathway
SNRPC	h_smPathway
SNRPD1	h_smPathway
SNRPD2	h_smPathway
SNRPD3	h_smPathway
SNRPF	h_smPathway
SNRPG	h_smPathway
SNW1	h_vdrPathway
SOCS1	h_ghPathway	h_il2rbPathway
SOCS3	h_il22bppathway	h_il2rbPathway
SOD1	h_flumazenilPathway	h_freePathway
SOD2	h_eponfkbPathway
SOD3	h_longevityPathway
SOS1	h_At1rPathway	h_HBxPathway	h_TPOPathway	h_bcrPathway	h_biopeptidesPathway	h_crebPathway	h_egfPathway	h_epoPathway	h_erkPathway	h_fcer1Pathway	h_ghPathway	h_gleevecpathway	h_her2Pathway	h_igf1Pathway	h_igf1rPathway	h_il2Pathway	h_il2rbPathway	h_il3Pathway	h_il6Pathway	h_insulinPathway	h_integrinPathway	h_metPathway	h_ngfPathway	h_pdgfPathway	h_ptenPathway	h_pyk2Pathway	h_spryPathway	h_tcrPathway	h_tffPathway	h_trkaPathway
SP100	h_pmlPathway
SP1	h_agrPathway	h_calcineurinPathway	h_hcmvPathway	h_keratinocytePathway	h_mapkPathway	h_pparaPathway	h_tercPathway	h_tertpathway
SP3	h_calcineurinPathway	h_tercPathway	h_tertpathway
SPEN	h_carm-erPathway
SPHK1	h_edg1Pathway
SPHKAP	h_edg1Pathway
SPP1	h_npp1Pathway
SPRY1	h_spryPathway
SPTAN1	h_HivnefPathway	h_PDZsPathway	h_deathPathway	h_fasPathway	h_tnfr1Pathway	h_ucalpainPathway
SPTBN1	h_PDZsPathway
SRA1	h_carm-erPathway	h_pparaPathway
SRC	h_At1rPathway	h_HBxPathway	h_achPathway	h_agrPathway	h_bArrestin-srcPathway	h_cblPathway	h_cell2cellPathway	h_ecmPathway	h_edg1Pathway	h_erkPathway	h_gabaPathway	h_integrinPathway	h_mPRPathway	h_metPathway	h_pelp1Pathway	h_pyk2Pathway	h_rhoPathway	h_sam68Pathway	h_sppaPathway	h_spryPathway	h_srcRPTPPathway	h_ucalpainPathway
SREBF1	h_s1pPathway
SREBF2	h_s1pPathway
SRF	h_egfPathway	h_ghPathway	h_hopPathway	h_igf1Pathway	h_il6Pathway	h_insulinPathway	h_malPathway	h_pdgfPathway
SSB	h_RNApol3Pathway
SST	h_ghrelinPathway
ST8SIA4	h_aMANpathway
STAT1	h_TPOPathway	h_chemicalPathway	h_egfPathway	h_gleevecpathway	h_ifnaPathway	h_ifngPathway	h_il22bppathway	h_mapkPathway	h_p38mapkPathway	h_pdgfPathway
STAT2	h_ifnaPathway
STAT3	h_TPOPathway	h_egfPathway	h_erkPathway	h_her2Pathway	h_il22bppathway	h_il6Pathway	h_metPathway	h_pdgfPathway	h_stat3Pathway
STAT4	h_IL12Pathway	h_no2il12Pathway
STAT5A	h_TPOPathway	h_biopeptidesPathway	h_egfPathway	h_epoPathway	h_ghPathway	h_gleevecpathway	h_il10Pathway	h_il22bppathway	h_il2Pathway	h_il2rbPathway	h_il3Pathway	h_il7Pathway	h_pdgfPathway	h_pparaPathway
STAT6	h_il4Pathway
STMN1	h_stathminPathway
STX1A	h_botulinPathway
SUFU	h_shhPathway
SUMO1	h_ctbp1Pathway	h_parkinPathway	h_pmlPathway	h_ranbp2Pathway	h_sumoPathway
SUMO2	h_sumoPathway
SUPT16H	h_vdrPathway
SUZ12	h_prc2Pathway
SYK	h_bcrPathway	h_fcer1Pathway	h_il2Pathway	h_il2rbPathway	h_nkcellsPathway	h_sppaPathway
SYNJ1	h_ndkDynaminPathway
TAF1	h_fibrinolysisPathway	h_p53hypoxiaPathway
TANK	h_stressPathway	h_tnfr2Pathway
TAP1	h_mhcPathway
TAP2	h_mhcPathway
TAX1BP3	h_tidPathway
TBP	h_RNApol3Pathway	h_carm-erPathway	h_hSWI-SNFpathway	h_rarrxrPathway
TBX2	h_arfPathway
TBXA2R	h_eicosanoidPathway
TBXAS1	h_eicosanoidPathway	h_sppaPathway
TEP1	h_telPathway
TERF1	h_telPathway
TERT	h_achPathway	h_telPathway
TFDP1	h_RacCycDPathway	h_cellcyclePathway	h_fbw7Pathway	h_g1Pathway	h_p27Pathway	h_skp2e2fPathway
TFF3	h_tffPathway
TF	h_eea1Pathway
TFPI	h_amiPathway	h_extrinsicPathway
TFRC	h_eea1Pathway
TGFB1	h_alkPathway	h_ctcfPathway	h_erythPathway	h_g1Pathway	h_il1rPathway	h_inflamPathway	h_mapkPathway	h_nktPathway	h_p38mapkPathway	h_slrp2Pathway	h_tgfbPathway	h_tob1Pathway
TGFBR1	h_alkPathway	h_mapkPathway	h_nthiPathway	h_p38mapkPathway	h_slrp2Pathway	h_tgfbPathway
TGFBR2	h_alkPathway	h_nthiPathway	h_tgfbPathway
TGFBR3	h_alkPathway	h_ctcfPathway	h_tob1Pathway
TGM2	h_plcdPathway
THBS1	h_tsp1Pathway
THPO	h_TPOPathway
THRA	h_egfr_smrtePathway
THY1	h_tcytotoxicPathway	h_thelperPathway
TIAL1	h_WNVpathway
TIMP1	h_reckPathway
TIMP2	h_reckPathway
TIMP3	h_p53Pathway	h_reckPathway
TIMP4	h_reckPathway
TIRAP	h_gsk3Pathway	h_tollPathway
TLE1	h_wntPathway
TLN1	h_chemicalPathway	h_ecmPathway	h_integrinPathway	h_mCalpainPathway	h_rhoPathway	h_ucalpainPathway
TLR10	h_tollPathway
TLR2	h_dcPathway	h_nthiPathway	h_tollPathway
TLR3	h_tollPathway
TLR4	h_dcPathway	h_gsk3Pathway	h_nfkbPathway	h_tollPathway
TLR6	h_tollPathway
TLR7	h_dcPathway	h_tollPathway
TLR9	h_dcPathway	h_tollPathway
TNF	h_HivnefPathway	h_LairPathway	h_RELAPathway	h_cdMacPathway	h_cytokinePathway	h_freePathway	h_granulocytesPathway	h_hsp27Pathway	h_il10Pathway	h_il1rPathway	h_inflamPathway	h_keratinocytePathway	h_mspPathway	h_nfkbPathway	h_nthiPathway	h_pmlPathway	h_pparaPathway	h_soddPathway	h_stressPathway	h_tidPathway	h_tnfr1Pathway	h_vobesityPathway
TNFRSF10A	h_deathPathway
TNFRSF11A	h_ranklPathway
TNFRSF13B	h_tall1Pathway
TNFRSF13C	h_tall1Pathway
TNFRSF17	h_tall1Pathway
TNFRSF1A	h_HivnefPathway	h_RELAPathway	h_ceramidePathway	h_keratinocytePathway	h_nfkbPathway	h_pmlPathway	h_soddPathway	h_stressPathway	h_tidPathway	h_tnfr1Pathway
TNFRSF1B	h_tnfr2Pathway
TNFRSF25	h_deathPathway
TNFRSF4	h_ox40Pathway
TNFRSF9	h_41bbPathway
TNFSF10	h_deathPathway
TNFSF11	h_ranklPathway
TNFSF12-TNFSF13	h_tall1Pathway
TNFSF13B	h_tall1Pathway
TNFSF4	h_ox40Pathway
TNFSF9	h_41bbPathway
TNKS	h_telPathway
TNNI1	h_no1Pathway
TNS1	h_integrinPathway
TOB1	h_tob1Pathway
TOLLIP	h_gsk3Pathway	h_il1rPathway	h_tollPathway
TOP2A	h_DNAfragmentPathway
TOP2B	h_vdrPathway
TP53	h_EfpPathway	h_arfPathway	h_atmPathway	h_atrbrcaPathway	h_btg2Pathway	h_chemicalPathway	h_ctcfPathway	h_g1Pathway	h_g2Pathway	h_p53Pathway	h_p53hypoxiaPathway	h_plk3Pathway	h_pmlPathway	h_rbPathway	h_rnaPathway	h_telPathway	h_tertpathway	h_tidPathway
TP73	h_atmPathway
TPI1	h_glycolysisPathway
TPX2	h_ranMSpathway
TRAC	h_CSKPathway	h_IL12Pathway	h_ctlPathway	h_ctla4Pathway	h_il17Pathway	h_mef2dPathway	h_tcapoptosisPathway	h_tcrPathway	h_tcraPathway	h_tcrmolecule	h_tcytotoxicPathway	h_thelperPathway	h_tob1Pathway
TRADD	h_HivnefPathway	h_RELAPathway	h_ceramidePathway	h_deathPathway	h_mapkPathway	h_nfkbPathway	h_p38mapkPathway	h_soddPathway	h_stressPathway	h_tnfr1Pathway
TRAF1	h_HivnefPathway	h_tnfr2Pathway
TRAF2	h_41bbPathway	h_HivnefPathway	h_ceramidePathway	h_deathPathway	h_keratinocytePathway	h_mapkPathway	h_p38mapkPathway	h_soddPathway	h_stressPathway	h_tall1Pathway	h_tnfr1Pathway	h_tnfr2Pathway
TRAF3	h_cd40Pathway	h_tall1Pathway	h_tnfr2Pathway
TRAF5	h_tall1Pathway
TRAF6	h_RELAPathway	h_cd40Pathway	h_il1rPathway	h_nfkbPathway	h_ranklPathway	h_tall1Pathway	h_tollPathway
TREX1	h_atrbrcaPathway
TRIM25	h_EfpPathway
TRIO	h_rac1Pathway
TRPC6	h_raccPathway
TRRAP	h_pitx2Pathway
TSC1	h_mTORPathway
TSC2	h_mTORPathway	h_vdrPathway
TSG101	h_stathminPathway
TUB	h_tubbyPathway
TWIST1	h_arfPathway
TYK2	h_IL12Pathway	h_ifnaPathway	h_il22bppathway	h_no2il12Pathway	h_stat3Pathway
U2AF1	h_smPathway
U2AF2	h_smPathway
UBA2	h_sumoPathway
UBE2D1	h_ErbB3Pathway
UBE2G2	h_parkinPathway
UBE2I	h_ctbp1Pathway	h_eradPathway	h_sumoPathway
UBE2L6	h_parkinPathway
UBE2M	h_p27Pathway
UBQLN1	h_gabaPathway
UGCGL1	h_eradPathway
UHMK1	h_stathminPathway
UQCRC1	h_etcPathway
UROD	h_ahspPathway
UROS	h_ahspPathway
USH1C	h_tidPathway
UTRN	h_agrPathway
VAMP2	h_botulinPathway
VAV1	h_bcrPathway	h_fcer1Pathway	h_nkcellsPathway	h_plcPathway	h_rac1Pathway	h_tcrPathway
VAV2	h_ptdinsPathway
VCAM1	h_LairPathway	h_lympathway
VCL	h_cell2cellPathway	h_integrinPathway	h_rhoPathway
VDR	h_nuclearRsPathway	h_vdrPathway
VEGFA	h_hifPathway	h_no1Pathway	h_vegfPathway
VHL	h_hifPathway	h_vegfPathway
VIP	h_vipPathway
VIPR2	h_vipPathway
VLDLR	h_reelinPathway
WASF1	h_rac1Pathway	h_salmonellaPathway
WASF2	h_actinYPathway
WASL	h_actinYPathway	h_cdc42racPathway	h_salmonellaPathway
WEE1	h_cdc25Pathway	h_g2Pathway	h_rbPathway
WIF1	h_wntPathway
WNT1	h_alkPathway	h_gsk3Pathway	h_hesPathway	h_pitx2Pathway	h_ps1Pathway	h_wntPathway
WNT8B	h_wnt-lrp6Pathway
WT1	h_tertpathway	h_tidPathway
XDH	h_freePathway
XIAP	h_bcellsurvivalPathway	h_caspasePathway	h_mitochondriaPathway
XPO1	h_cremPathway	h_ptc1Pathway
XRCC5	h_telPathway
XRCC6	h_telPathway
YBX1	h_dbpbPathway
YWHAH	h_MITRPathway	h_achPathway	h_aktPathway	h_badPathway	h_cdc25Pathway	h_g2Pathway	h_hdacPathway	h_igf1rPathway	h_pgc1aPathway	h_plk3Pathway	h_rbPathway
YWHAQ	h_g2Pathway
YY1	h_prc2Pathway
ZAP70	h_CSKPathway	h_tcrPathway	h_tcraPathway
ZBTB16	h_egfr_smrtePathway
ZBTB7A	h_bcellsurvivalPathway
ZEB1	h_ctbp1Pathway
ZFYVE9	h_tgfbPathway
ZYX	h_integrinPathway
